Label,State,State Abbrv,Total:,Urban:,Inside urbanized areas,Inside urban clusters,Rural:,Farm,Nonfarm,% Rural,Class,StateFIPS,FIPScounty
Abbeville County,South Carolina,SC,26167,6130,0,6130,20037,723,19314,76.57354683,MR,45,45001
Acadia Parish,Louisiana,LA,58861,29719,312,29407,29142,859,28283,49.50986222,MU,22,22001
Accomack County,Virginia,VA,38305,3822,0,3822,34483,718,33765,90.02219031,MR,51,51001
Ada County,Idaho,ID,300904,280506,272073,8433,20398,2203,18195,6.778906229,MU,16,16001
Adair County,Iowa,IA,8243,0,0,0,8243,1341,6902,100,CR,19,19001
Adair County,Kentucky,KY,17244,4374,0,4374,12870,1674,11196,74.63465553,MR,21,21001
Adair County,Missouri,MO,24977,16498,0,16498,8479,1062,7417,33.94723145,MU,29,29001
Adair County,Oklahoma,OK,21038,3294,0,3294,17744,1551,16193,84.34261812,MR,40,40001
Adams County,Colorado,CO,363857,349607,328426,21181,14250,800,13450,3.91637374,MU,8,8001
Adams County,Idaho,ID,3476,0,0,0,3476,362,3114,100,CR,16,16003
Adams County,Illinois,IL,68277,45235,0,45235,23042,2290,20752,33.74782137,MU,17,17001
Adams County,Indiana,IN,33625,14635,0,14635,18990,3316,15674,56.47583643,MR,18,18001
Adams County,Iowa,IA,4482,0,0,0,4482,948,3534,100,CR,19,19003
Adams County,Mississippi,MS,34340,23557,0,23557,10783,237,10546,31.40069889,MU,28,28001
Adams County,Nebraska,NE,31151,24131,0,24131,7020,880,6140,22.53539212,MU,31,31001
Adams County,North Dakota,ND,2593,0,0,0,2593,480,2113,100,CR,38,38001
Adams County,Ohio,OH,27330,2672,0,2672,24658,2206,22452,90.22319795,MR,39,39001
Adams County,Pennsylvania,PA,91292,36693,0,36693,54599,2098,52501,59.80699295,MR,42,42001
Adams County,Washington,WA,16428,7686,0,7686,8742,868,7874,53.21402484,MR,53,53001
Adams County,Wisconsin,WI,18643,0,0,0,18643,700,17943,100,CR,55,55001
Addison County,Vermont,VT,35974,7407,0,7407,28567,1429,27138,79.41012954,MR,50,50001
Aiken County,South Carolina,SC,142552,86786,84289,2497,55766,1003,54763,39.11975981,MU,45,45003
Aitkin County,Minnesota,MN,15301,0,0,0,15301,719,14582,100,CR,27,27001
Alachua County,Florida,FL,217955,162079,159285,2794,55876,2089,53787,25.6364846,MU,12,12001
Alamance County,North Carolina,NC,130800,90615,90615,0,40185,1025,39160,30.72247706,MU,37,37001
Alameda County,California,CA,1443741,1435570,1435570,0,8171,222,7949,0.565960238,MU,6,6001
Alamosa County,Colorado,CO,14966,9069,0,9069,5897,623,5274,39.402646,MU,8,8003
Albany County,New York,NY,294565,265780,261067,4713,28785,585,28200,9.772036732,MU,36,36001
Albany County,Wyoming,WY,32014,28246,0,28246,3768,455,3313,11.76985069,MU,56,56001
Albemarle County,Virginia,VA,79236,40934,36232,4702,38302,922,37380,48.33913878,MU,51,51003
Alcona County,Michigan,MI,11719,181,0,181,11538,221,11317,98.45549962,MR,26,26001
Alcorn County,Mississippi,MS,34558,11796,0,11796,22762,441,22321,65.86608021,MR,28,28003
Aleutians East Borough,Alaska,AK,2697,0,0,0,2697,0,2697,100,CR,2,2013
Aleutians West Census Area,Alaska,AK,5465,2890,0,2890,2575,11,2564,47.11802379,MU,2,2016
Alexander County,Illinois,IL,9590,3969,0,3969,5621,157,5464,58.61313869,MR,17,17003
Alexander County,North Carolina,NC,33603,5792,2474,3318,27811,851,26960,82.76344374,MR,37,37003
Alexandria city,Virginia,VA,128283,128283,128283,0,0,0,0,0,MU,51,51510
Alfalfa County,Oklahoma,OK,6105,0,0,0,6105,614,5491,100,CR,40,40003
Alger County,Michigan,MI,9862,0,0,0,9862,103,9759,100,CR,26,26003
Allamakee County,Iowa,IA,14675,4132,0,4132,10543,2021,8522,71.84327087,MR,19,19005
Allegan County,Michigan,MI,105665,31392,9879,21513,74273,2882,71391,70.29101405,MR,26,26005
Allegany County,Maryland,MD,74930,55685,0,55685,19245,274,18971,25.68397171,MU,24,24001
Allegany County,New York,NY,49927,10301,0,10301,39626,1212,38414,79.3678771,MR,36,36003
Alleghany County,North Carolina,NC,10677,0,0,0,10677,640,10037,100,CR,37,37005
Alleghany County,Virginia,VA,12926,3548,0,3548,9378,204,9174,72.5514467,MR,51,51005
Allegheny County,Pennsylvania,PA,1281666,1246898,1246898,0,34768,190,34578,2.712719226,MU,42,42003
Allen County,Indiana,IN,331849,287516,287516,0,44333,3492,40841,13.35938936,MU,18,18003
Allen County,Kansas,KS,14385,6343,0,6343,8042,906,7136,55.90545707,MR,20,20001
Allen County,Kentucky,KY,17800,4018,0,4018,13782,1711,12071,77.42696629,MR,21,21003
Allen County,Ohio,OH,108473,79600,71970,7630,28873,2023,26850,26.61768366,MU,39,39003
Allen Parish,Louisiana,LA,25440,8121,0,8121,17319,337,16982,68.07783019,MR,22,22003
Allendale County,South Carolina,SC,11211,6616,0,6616,4595,124,4471,40.98653109,MU,45,45005
Alpena County,Michigan,MI,31314,15211,0,15211,16103,742,15361,51.42428307,MR,26,26007
Alpine County,California,CA,1208,0,0,0,1208,3,1205,100,CR,6,6003
Amador County,California,CA,35100,13825,0,13825,21275,521,20754,60.61253561,MR,6,6005
Amelia County,Virginia,VA,11400,0,0,0,11400,564,10836,100,CR,51,51007
Amherst County,Virginia,VA,31894,11782,11782,0,20112,442,19670,63.05888255,MR,51,51009
Amite County,Mississippi,MS,13599,0,0,0,13599,529,13070,100,CR,28,28005
Anchorage Municipality,Alaska,AK,260283,250153,225606,24547,10130,0,10130,3.891917643,MU,2,2020
Anderson County,Kansas,KS,8110,3415,0,3415,4695,1343,3352,57.89149199,MR,20,20003
Anderson County,Kentucky,KY,19111,9726,0,9726,9385,1046,8339,49.10784365,MU,21,21005
Anderson County,South Carolina,SC,165740,96680,80508,16172,69060,1700,67360,41.66767226,MU,45,45007
Anderson County,Tennessee,TN,71330,42056,41,42015,29274,844,28430,41.04023553,MU,47,47001
Anderson County,Texas,TX,55109,32375,0,32375,22734,1253,21481,41.25278993,MU,48,48001
Andrew County,Missouri,MO,16492,6547,1981,4566,9945,1319,8626,60.30196459,MR,29,29003
Andrews County,Texas,TX,13004,10515,0,10515,2489,75,2414,19.14026453,MU,48,48003
Androscoggin County,Maine,ME,103793,59522,50543,8979,44271,536,43735,42.65316544,MU,23,23001
Angelina County,Texas,TX,80130,44289,0,44289,35841,774,35067,44.72856608,MU,48,48005
Anne Arundel County,Maryland,MD,489656,462127,451685,10442,27529,725,26804,5.622110216,MU,24,24003
Anoka County,Minnesota,MN,298084,255331,252555,2776,42753,599,42154,14.34260141,MU,27,27003
Anson County,North Carolina,NC,25275,6660,0,6660,18615,687,17928,73.64985163,MR,37,37007
Antelope County,Nebraska,NE,7452,0,0,0,7452,1685,5767,100,CR,31,31003
Antrim County,Michigan,MI,23110,0,0,0,23110,419,22691,100,CR,26,26009
Apache County,Arizona,AZ,69423,16606,0,16606,52817,433,52384,76.0799735,MR,4,4001
Appanoose County,Iowa,IA,13721,5580,0,5580,8141,1304,6837,59.33241017,MR,19,19007
Appling County,Georgia,GA,17419,5211,0,5211,12208,695,11513,70.08439061,MR,13,13001
Appomattox County,Virginia,VA,13705,0,0,0,13705,466,13239,100,CR,51,51011
Aransas County,Texas,TX,22497,14884,0,14884,7613,12,7601,33.84006756,MU,48,48007
Arapahoe County,Colorado,CO,487967,478124,478124,0,9843,425,9418,2.017144602,MU,8,8005
Archer County,Texas,TX,8854,994,994,0,7860,508,7352,88.77343574,MR,48,48009
Archuleta County,Colorado,CO,9898,3644,0,3644,6254,238,6016,63.18448171,MR,8,8007
Arenac County,Michigan,MI,17269,0,0,0,17269,474,16795,100,CR,26,26011
Arkansas County,Arkansas,AR,20749,13100,0,13100,7649,463,7186,36.8644272,MU,5,5001
Arlington County,Virginia,VA,189453,189453,189453,0,0,0,0,0,MU,51,51013
Armstrong County,Pennsylvania,PA,72392,26698,1998,24700,45694,888,44806,63.12023428,MR,42,42005
Armstrong County,Texas,TX,2148,0,0,0,2148,297,1851,100,CR,48,48011
Aroostook County,Maine,ME,73938,16768,0,16768,57170,1173,55997,77.32153967,MR,23,23003
Arthur County,Nebraska,NE,444,0,0,0,444,127,317,100,CR,31,31005
Ascension Parish,Louisiana,LA,76627,57744,49681,8063,18883,306,18577,24.64274994,MU,22,22005
Ashe County,North Carolina,NC,24384,0,0,0,24384,1038,23346,100,CR,37,37009
Ashland County,Ohio,OH,52523,24104,0,24104,28419,2408,26011,54.10772424,MR,39,39005
Ashland County,Wisconsin,WI,16866,7883,0,7883,8983,331,8652,53.26099846,MR,55,55003
Ashley County,Arkansas,AR,24209,11892,0,11892,12317,266,12051,50.87777273,MR,5,5003
Ashtabula County,Ohio,OH,102728,55726,0,55726,47002,2071,44931,45.75383537,MU,39,39007
Asotin County,Washington,WA,20551,19359,19359,0,1192,323,869,5.80020437,MU,53,53003
Assumption Parish,Louisiana,LA,23388,13157,3204,9953,10231,157,10074,43.74465538,MU,22,22007
Atascosa County,Texas,TX,38628,15293,0,15293,23335,1490,21845,60.40954748,MR,48,48013
Atchison County,Kansas,KS,16774,10487,0,10487,6287,1164,5123,37.48062478,MU,20,20005
Atchison County,Missouri,MO,6430,0,0,0,6430,612,5818,100,CR,29,29005
Athens County,Ohio,OH,62223,36567,0,36567,25656,847,24809,41.23234174,MU,39,39009
Atkinson County,Georgia,GA,7609,0,0,0,7609,212,7397,100,CR,13,13003
Atlantic County,New Jersey,NJ,252552,216446,200440,16006,36106,761,35345,14.29646172,MU,34,34001
Atoka County,Oklahoma,OK,13879,2447,0,2447,11432,1110,10322,82.36904676,MR,40,40005
Attala County,Mississippi,MS,19661,7002,0,7002,12659,523,12136,64.38634861,MR,28,28007
Audrain County,Missouri,MO,25853,14899,0,14899,10954,2282,8672,42.37032453,MU,29,29007
Audubon County,Iowa,IA,6830,0,0,0,6830,1375,5455,100,CR,19,19009
Auglaize County,Ohio,OH,46611,27597,2068,25529,19014,2579,16435,40.79294587,MU,39,39011
Augusta County,Virginia,VA,65615,14462,0,14462,51153,2227,48926,77.95930809,MR,51,51015
Aurora County,South Dakota,SD,3058,0,0,0,3058,819,2239,100,CR,46,46003
Austin County,Texas,TX,23590,8766,0,8766,14824,1293,13531,62.84018652,MR,48,48015
Autauga County,Alabama,AL,43671,24210,0,24210,19461,609,18852,44.56275331,MU,1,1001
Avery County,North Carolina,NC,17167,0,0,0,17167,836,16331,100,CR,37,37011
Avoyelles Parish,Louisiana,LA,41481,15716,0,15716,25765,872,24893,62.11277452,MR,22,22009
Baca County,Colorado,CO,4517,0,0,0,4517,647,3870,100,CR,8,8009
Bacon County,Georgia,GA,10103,2681,0,2681,7422,282,7140,73.46332772,MR,13,13005
Bailey County,Texas,TX,6594,4197,0,4197,2397,403,1994,36.35122839,MU,48,48017
Baker County,Florida,FL,22259,8391,0,8391,13868,219,13649,62.30288872,MR,12,12003
Baker County,Georgia,GA,4074,0,0,0,4074,138,3936,100,CR,13,13007
Baker County,Oregon,OR,16741,9373,0,9373,7368,1687,5681,44.01170778,MU,41,41001
Baldwin County,Alabama,AL,140415,63708,1948,61760,76707,1354,75353,54.62877898,MR,1,1003
Baldwin County,Georgia,GA,44700,29515,0,29515,15185,323,14862,33.97091723,MU,13,13009
Ballard County,Kentucky,KY,8286,0,0,0,8286,683,7603,100,CR,21,21007
Baltimore city,Maryland,MD,651154,651154,651154,0,0,0,0,0,MU,24,24510
Baltimore County,Maryland,MD,754292,707476,706662,814,46816,1451,45365,6.206614945,MU,24,24005
Bamberg County,South Carolina,SC,16658,7614,0,7614,9044,620,8424,54.29223196,MR,45,45009
Bandera County,Texas,TX,17645,0,0,0,17645,532,17113,100,CR,48,48019
Banks County,Georgia,GA,14422,830,0,830,13592,684,12908,94.24490362,MR,13,13011
Banner County,Nebraska,NE,819,0,0,0,819,329,490,100,CR,31,31007
Bannock County,Idaho,ID,75565,62514,62514,0,13051,685,12366,17.27122345,MU,16,16005
Baraga County,Michigan,MI,8746,0,0,0,8746,85,8661,100,CR,26,26013
Barber County,Kansas,KS,5307,0,0,0,5307,487,4820,100,CR,20,20007
Barbour County,Alabama,AL,29038,8574,0,8574,20464,529,19935,70.47317308,MR,1,1005
Barbour County,West Virginia,WV,15557,2589,0,2589,12968,485,12483,83.3579739,MR,54,54001
Barnes County,North Dakota,ND,11775,6729,0,6729,5046,1312,3734,42.85350318,MU,38,38003
Barnstable County,Massachusetts,MA,222230,202758,199327,3431,19472,73,19399,8.762093327,MU,25,25001
Barnwell County,South Carolina,SC,23478,3496,0,3496,19982,409,19573,85.10946418,MR,45,45011
Barren County,Kentucky,KY,38033,13638,0,13638,24395,3015,21380,64.14166645,MR,21,21009
Barron County,Wisconsin,WI,44963,12535,0,12535,32428,3119,29309,72.12152214,MR,55,55005
Barrow County,Georgia,GA,46144,21654,8209,13445,24490,595,23895,53.0729889,MR,13,13013
Barry County,Michigan,MI,56755,10968,0,10968,45787,1588,44199,80.67483041,MR,26,26015
Barry County,Missouri,MO,34010,8678,0,8678,25332,2422,22910,74.4839753,MR,29,29009
Bartholomew County,Indiana,IN,71435,48758,46241,2517,22677,1490,21187,31.74494296,MU,18,18005
Barton County,Kansas,KS,28205,18812,0,18812,9393,939,8454,33.30260592,MU,20,20009
Barton County,Missouri,MO,12541,4293,0,4293,8248,1566,6682,65.76828004,MR,29,29011
Bartow County,Georgia,GA,76019,44676,7899,36777,31343,642,30701,41.23048185,MU,13,13015
Bastrop County,Texas,TX,57733,19020,0,19020,38713,1748,36965,67.05523704,MR,48,48021
Bates County,Missouri,MO,16653,3750,0,3750,12903,1779,11124,77.48153486,MR,29,29013
Bath County,Kentucky,KY,11085,0,0,0,11085,1258,9827,100,CR,21,21011
Bath County,Virginia,VA,5048,0,0,0,5048,176,4872,100,CR,51,51017
Baxter County,Arkansas,AR,38386,12528,0,12528,25858,454,25404,67.36310113,MR,5,5005
Bay County,Florida,FL,148217,132467,132467,0,15750,94,15656,10.62631142,MU,12,12005
Bay County,Michigan,MI,110157,78047,74183,3864,32110,1661,30449,29.14930508,MU,26,26017
Bayfield County,Wisconsin,WI,15013,0,0,0,15013,515,14498,100,CR,55,55007
Baylor County,Texas,TX,4093,2741,0,2741,1352,208,1144,33.03200586,MU,48,48023
Beadle County,South Dakota,SD,17023,11970,0,11970,5053,1373,3680,29.68336956,MU,46,46005
Bear Lake County,Idaho,ID,6411,2712,0,2712,3699,395,3304,57.69770707,MR,16,16007
Beaufort County,North Carolina,NC,44958,14080,0,14080,30878,780,30098,68.68188087,MR,37,37013
Beaufort County,South Carolina,SC,120937,86383,0,86383,34554,703,33851,28.57190107,MU,45,45013
Beauregard Parish,Louisiana,LA,32986,9718,0,9718,23268,902,22366,70.53901655,MR,22,22011
Beaver County,Oklahoma,OK,5857,0,0,0,5857,851,5006,100,CR,40,40007
Beaver County,Pennsylvania,PA,181412,132843,129586,3257,48569,591,47978,26.77276035,MU,42,42007
Beaver County,Utah,UT,6005,0,0,0,6005,160,5845,100,CR,49,49001
Beaverhead County,Montana,MT,9202,4301,0,4301,4901,864,4037,53.26016083,MR,30,30001
Becker County,Minnesota,MN,30000,7281,0,7281,22719,1653,21066,75.73,MR,27,27005
Beckham County,Oklahoma,OK,19799,13879,0,13879,5920,755,5165,29.90050003,MU,40,40009
Bedford city,Virginia,VA,6299,6299,0,6299,0,0,0,0,MU,51,51515
Bedford County,Pennsylvania,PA,49984,7819,0,7819,42165,1731,40434,84.35699424,MR,42,42009
Bedford County,Tennessee,TN,37586,15312,0,15312,22274,2281,19993,59.26142713,MR,47,47003
Bedford County,Virginia,VA,60371,9238,8749,489,51133,1364,49769,84.697951,MR,51,51019
Bee County,Texas,TX,32359,22448,0,22448,9911,753,9158,30.62826416,MU,48,48025
Belknap County,New Hampshire,NH,56325,22471,0,22471,33854,329,33525,60.10474922,MR,33,33001
Bell County,Kentucky,KY,30060,11118,0,11118,18942,144,18798,63.01397206,MR,21,21013
Bell County,Texas,TX,237974,194107,193306,801,43867,2152,41715,18.43352635,MU,48,48027
Belmont County,Ohio,OH,70226,36625,29082,7543,33601,817,32784,47.84695127,MU,39,39013
Beltrami County,Minnesota,MN,39650,12492,0,12492,27158,1244,25914,68.49432535,MR,27,27007
Ben Hill County,Georgia,GA,17484,11404,0,11404,6080,171,5909,34.77465111,MU,13,13017
Benewah County,Idaho,ID,9171,2879,0,2879,6292,250,6042,68.60756733,MR,16,16009
Bennett County,South Dakota,SD,3574,0,0,0,3574,307,3267,100,CR,46,46007
Bennington County,Vermont,VT,36994,14134,0,14134,22860,327,22533,61.7938044,MR,50,50003
Benson County,North Dakota,ND,6964,0,0,0,6964,689,6275,100,CR,38,38005
Bent County,Colorado,CO,5998,3507,0,3507,2491,587,1904,41.53051017,MU,8,8011
Benton County,Arkansas,AR,153406,90015,65173,24842,63391,3291,60100,41.32237331,MU,5,5007
Benton County,Indiana,IN,9421,0,0,0,9421,718,8703,100,CR,18,18007
Benton County,Iowa,IA,25308,7491,0,7491,17817,2456,15361,70.40066382,MR,19,19011
Benton County,Minnesota,MN,34226,20217,20217,0,14009,1957,12052,40.93087127,MU,27,27009
Benton County,Mississippi,MS,8026,0,0,0,8026,222,7804,100,CR,28,28009
Benton County,Missouri,MO,17180,0,0,0,17180,1180,16000,100,CR,29,29015
Benton County,Oregon,OR,78153,63222,58064,5158,14931,1510,13421,19.10483283,MU,41,41003
Benton County,Tennessee,TN,16537,3654,0,3654,12883,400,12483,77.90409385,MR,47,47005
Benton County,Washington,WA,142475,124926,115574,9352,17549,1808,15741,12.31724864,MU,53,53005
Benzie County,Michigan,MI,15998,0,0,0,15998,211,15787,100,CR,26,26019
Bergen County,New Jersey,NJ,884118,882615,882615,0,1503,0,1503,0.169999932,MU,34,34003
Berkeley County,South Carolina,SC,142651,94157,84900,9257,48494,1293,47201,33.99485458,MU,45,45015
Berkeley County,West Virginia,WV,75905,41188,33482,7706,34717,519,34198,45.73743495,MU,54,54003
Berks County,Pennsylvania,PA,373638,272124,251259,20865,101514,3804,97710,27.16907809,MU,42,42011
Berkshire County,Massachusetts,MA,134953,94243,52838,41405,40710,677,40033,30.16605781,MU,25,25003
Bernalillo County,New Mexico,NM,556678,532555,532555,0,24123,134,23989,4.333384829,MU,35,35001
Berrien County,Georgia,GA,16235,4103,0,4103,12132,341,11791,74.72744071,MR,13,13019
Berrien County,Michigan,MI,162453,113120,91981,21139,49333,2365,46968,30.36755246,MU,26,26021
Bertie County,North Carolina,NC,19773,0,0,0,19773,486,19287,100,CR,37,37015
Bethel Census Area,Alaska,AK,16006,4363,0,4363,11643,7,11636,72.74147195,MR,2,2050
Bexar County,Texas,TX,1392931,1310038,1306098,3940,82893,2211,80682,5.950976753,MU,48,48029
Bibb County,Alabama,AL,20826,3785,0,3785,17041,224,16817,81.82560261,MR,1,1007
Bibb County,Georgia,GA,153887,131130,131130,0,22757,215,22542,14.78812375,MU,13,13021
Bienville Parish,Louisiana,LA,15752,3109,0,3109,12643,311,12332,80.26282377,MR,22,22013
Big Horn County,Montana,MT,12671,3511,0,3511,9160,571,8589,72.29105832,MR,30,30003
Big Horn County,Wyoming,WY,11461,0,0,0,11461,940,10521,100,CR,56,56003
Big Stone County,Minnesota,MN,5820,0,0,0,5820,835,4985,100,CR,27,27011
Billings County,North Dakota,ND,888,0,0,0,888,376,512,100,CR,38,38007
Bingham County,Idaho,ID,41735,17514,0,17514,24221,2382,21839,58.03522224,MR,16,16011
Black Hawk County,Iowa,IA,128012,108187,108187,0,19825,2424,17401,15.48682936,MU,19,19013
Blackford County,Indiana,IN,14048,7087,0,7087,6961,774,6187,49.55153759,MU,18,18009
Bladen County,North Carolina,NC,32278,3582,0,3582,28696,967,27729,88.90265816,MR,37,37017
Blaine County,Idaho,ID,18991,12478,0,12478,6513,359,6154,34.29519246,MU,16,16013
Blaine County,Montana,MT,7009,0,0,0,7009,793,6216,100,CR,30,30005
Blaine County,Nebraska,NE,583,0,0,0,583,182,401,100,CR,31,31009
Blaine County,Oklahoma,OK,11976,4661,0,4661,7315,871,6444,61.08049432,MR,40,40011
Blair County,Pennsylvania,PA,129144,95621,82754,12867,33523,1048,32475,25.95784551,MU,42,42013
Blanco County,Texas,TX,8418,0,0,0,8418,725,7693,100,CR,48,48031
Bland County,Virginia,VA,6871,0,0,0,6871,439,6432,100,CR,51,51021
Bleckley County,Georgia,GA,11666,5532,0,5532,6134,446,5688,52.58014744,MR,13,13023
Bledsoe County,Tennessee,TN,12367,0,0,0,12367,658,11709,100,CR,47,47007
Blount County,Alabama,AL,51024,4695,0,4695,46329,1437,44892,90.79844779,MR,1,1009
Blount County,Tennessee,TN,105823,67114,67114,0,38709,748,37961,36.57900456,MU,47,47009
Blue Earth County,Minnesota,MN,55941,35288,0,35288,20653,2346,18307,36.91925421,MU,27,27013
Boise County,Idaho,ID,6670,0,0,0,6670,104,6566,100,CR,16,16015
Bolivar County,Mississippi,MS,40633,23478,0,23478,17155,523,16632,42.21937834,MU,28,28011
Bollinger County,Missouri,MO,12029,0,0,0,12029,850,11179,100,CR,29,29017
Bon Homme County,South Dakota,SD,7260,0,0,0,7260,1493,5767,100,CR,46,46009
Bond County,Illinois,IL,17633,7046,0,7046,10587,1110,9477,60.04083253,MR,17,17005
Bonner County,Idaho,ID,36835,8299,0,8299,28536,913,27623,77.46979775,MR,16,16017
Bonneville County,Idaho,ID,82522,67032,67032,0,15490,1332,14158,18.77075204,MU,16,16019
Boone County,Arkansas,AR,33948,13061,0,13061,20887,1322,19565,61.52645222,MR,5,5009
Boone County,Illinois,IL,41786,29077,29077,0,12709,1351,11358,30.41449289,MU,17,17007
Boone County,Indiana,IN,46107,24968,10644,14324,21139,1069,20070,45.84770208,MU,18,18011
Boone County,Iowa,IA,26224,12633,203,12430,13591,1536,12055,51.82657108,MR,19,19015
Boone County,Kentucky,KY,85991,64744,64744,0,21247,1127,20120,24.70839972,MU,21,21015
Boone County,Missouri,MO,135454,102434,98767,3667,33020,1580,31440,24.37727937,MU,29,29019
Boone County,Nebraska,NE,6259,0,0,0,6259,1403,4856,100,CR,31,31011
Boone County,West Virginia,WV,25535,3058,0,3058,22477,21,22456,88.0242804,MR,54,54005
Borden County,Texas,TX,729,0,0,0,729,272,457,100,CR,48,48033
Bosque County,Texas,TX,17204,3588,0,3588,13616,933,12683,79.14438503,MR,48,48035
Bossier Parish,Louisiana,LA,98310,70916,66430,4486,27394,625,26769,27.8649171,MU,22,22015
Botetourt County,Virginia,VA,30496,10023,9995,28,20473,769,19704,67.13339454,MR,51,51023
Bottineau County,North Dakota,ND,7149,0,0,0,7149,921,6228,100,CR,38,38009
Boulder County,Colorado,CO,291288,264455,264455,0,26833,928,25905,9.211845321,MU,8,8013
Boundary County,Idaho,ID,9871,2632,0,2632,7239,584,6655,73.33603485,MR,16,16021
Bourbon County,Kansas,KS,15379,7879,0,7879,7500,1111,6389,48.76780025,MU,20,20011
Bourbon County,Kentucky,KY,19360,10619,0,10619,8741,1898,6843,45.14979339,MU,21,21017
Bowie County,Texas,TX,89306,59621,48741,10880,29685,1095,28590,33.23964795,MU,48,48037
Bowman County,North Dakota,ND,3242,0,0,0,3242,394,2848,100,CR,38,38011
Box Butte County,Nebraska,NE,12158,8921,0,8921,3237,634,2603,26.62444481,MU,31,31013
Box Elder County,Utah,UT,42745,28060,77,27983,14685,1242,13443,34.35489531,MU,49,49003
Boyd County,Kentucky,KY,49752,36988,36988,0,12764,78,12686,25.65525004,MU,21,21019
Boyd County,Nebraska,NE,2438,0,0,0,2438,628,1810,100,CR,31,31015
Boyle County,Kentucky,KY,27697,17502,0,17502,10195,874,9321,36.80904069,MU,21,21021
Bracken County,Kentucky,KY,8279,0,0,0,8279,1317,6962,100,CR,21,21023
Bradford County,Florida,FL,26088,9109,0,9109,16979,431,16548,65.08356332,MR,12,12007
Bradford County,Pennsylvania,PA,62761,17449,0,17449,45312,1908,43404,72.19770239,MR,42,42015
Bradley County,Arkansas,AR,12600,6029,0,6029,6571,242,6329,52.15079365,MR,5,5011
Bradley County,Tennessee,TN,87965,58439,58439,0,29526,905,28621,33.56562269,MU,47,47011
Branch County,Michigan,MI,45787,14441,0,14441,31346,2413,28933,68.46048005,MR,26,26023
Brantley County,Georgia,GA,14629,160,0,160,14469,281,14188,98.90628204,MR,13,13025
Braxton County,West Virginia,WV,14702,0,0,0,14702,390,14312,100,CR,54,54007
Brazoria County,Texas,TX,241767,173135,161011,12124,68632,1415,67217,28.3876625,MU,48,48039
Brazos County,Texas,TX,152415,132839,132839,0,19576,1146,18430,12.8438802,MU,48,48041
Breathitt County,Kentucky,KY,16100,3279,0,3279,12821,351,12470,79.63354037,MR,21,21025
Breckinridge County,Kentucky,KY,18648,0,0,0,18648,2307,16341,100,CR,21,21027
Bremer County,Iowa,IA,23325,7518,0,7518,15807,2144,13663,67.76848875,MR,19,19017
Brevard County,Florida,FL,476230,454578,454578,0,21652,401,21251,4.546542637,MU,12,12009
Brewster County,Texas,TX,8866,5893,0,5893,2973,37,2936,33.53259644,MU,48,48043
Briscoe County,Texas,TX,1790,0,0,0,1790,210,1580,100,CR,48,48045
Bristol Bay Borough,Alaska,AK,1258,0,0,0,1258,0,1258,100,CR,2,2060
Bristol city,Virginia,VA,17367,17222,17222,0,145,0,145,0.834916796,MU,51,51520
Bristol County,Massachusetts,MA,534678,480716,480716,0,53962,442,53520,10.09242946,MU,25,25005
Bristol County,Rhode Island,RI,50648,50423,50423,0,225,0,225,0.444242616,MU,44,44001
Broadwater County,Montana,MT,4385,0,0,0,4385,589,3796,100,CR,30,30007
Bronx County,New York,NY,1332650,1332650,1332650,0,0,0,0,0,MU,36,36005
Brooke County,West Virginia,WV,25447,14606,14606,0,10841,74,10767,42.60227139,MU,54,54009
Brookings County,South Dakota,SD,28220,18575,0,18575,9645,1639,8006,34.17788802,MU,46,46011
Brooks County,Georgia,GA,16450,4879,0,4879,11571,625,10946,70.34042553,MR,13,13027
Brooks County,Texas,TX,7976,5815,0,5815,2161,150,2011,27.09378134,MU,48,48047
Broome County,New York,NY,200536,147942,147942,0,52594,802,51792,26.22671241,MU,36,36007
Broward County,Florida,FL,1623018,1620756,1620756,0,2262,100,2162,0.139369989,MU,12,12011
Brown County,Illinois,IL,6950,4077,0,4077,2873,681,2192,41.3381295,MU,17,17009
Brown County,Indiana,IN,14957,0,0,0,14957,190,14767,100,CR,18,18013
Brown County,Kansas,KS,10724,3492,0,3492,7232,1026,6206,67.43752331,MR,20,20013
Brown County,Minnesota,MN,26911,16845,0,16845,10066,2380,7686,37.40477872,MU,27,27015
Brown County,Nebraska,NE,3525,0,0,0,3525,559,2966,100,CR,31,31017
Brown County,Ohio,OH,42285,8185,0,8185,34100,3028,31072,80.64325411,MR,39,39015
Brown County,South Dakota,SD,35460,24716,0,24716,10744,1504,9240,30.29892837,MU,46,46013
Brown County,Texas,TX,37674,21976,0,21976,15698,1044,14654,41.66799384,MU,48,48049
Brown County,Wisconsin,WI,226778,190344,187412,2932,36434,2039,34395,16.06593232,MU,55,55009
Brule County,South Dakota,SD,5364,0,0,0,5364,823,4541,100,CR,46,46015
Brunswick County,North Carolina,NC,73143,24735,8149,16586,48408,551,47857,66.18268324,MR,37,37019
Brunswick County,Virginia,VA,18419,4460,0,4460,13959,820,13139,75.78587328,MR,51,51025
Bryan County,Georgia,GA,23417,9261,0,9261,14156,89,14067,60.45180852,MR,13,13029
Bryan County,Oklahoma,OK,36534,13324,0,13324,23210,1197,22013,63.52986259,MR,40,40013
Buchanan County,Iowa,IA,21093,5810,0,5810,15283,2784,12499,72.45531693,MR,19,19019
Buchanan County,Missouri,MO,85998,74504,74473,31,11494,1349,10145,13.3654271,MU,29,29021
Buchanan County,Virginia,VA,26978,0,0,0,26978,292,26686,100,CR,51,51027
Buckingham County,Virginia,VA,15623,0,0,0,15623,691,14932,100,CR,51,51029
Bucks County,Pennsylvania,PA,597635,538565,532670,5895,59070,732,58338,9.883959273,MU,42,42017
Buena Vista city,Virginia,VA,6349,6157,0,6157,192,0,192,3.024098283,MU,51,51530
Buena Vista County,Iowa,IA,20411,10681,0,10681,9730,1603,8127,47.67037382,MU,19,19021
Buffalo County,Nebraska,NE,42259,27111,0,27111,15148,1629,13519,35.84561868,MU,31,31019
Buffalo County,South Dakota,SD,2032,0,0,0,2032,146,1886,100,CR,46,46017
Buffalo County,Wisconsin,WI,13804,0,0,0,13804,2095,11709,100,CR,55,55011
Bullitt County,Kentucky,KY,61236,39539,39539,0,21697,562,21135,35.43177216,MU,21,21029
Bulloch County,Georgia,GA,55983,27162,0,27162,28821,619,28202,51.4816998,MR,13,13031
Bullock County,Alabama,AL,11714,4499,0,4499,7215,310,6905,61.59296568,MR,1,1011
Buncombe County,North Carolina,NC,206330,146506,146506,0,59824,1257,58567,28.99432947,MU,37,37021
Bureau County,Illinois,IL,35503,13595,0,13595,21908,2103,19805,61.70746134,MR,17,17011
Burke County,Georgia,GA,22243,5486,0,5486,16757,772,15985,75.33606078,MR,13,13033
Burke County,North Carolina,NC,89148,48462,48462,0,40686,344,40342,45.63871315,MU,37,37023
Burke County,North Dakota,ND,2242,0,0,0,2242,475,1767,100,CR,38,38013
Burleigh County,North Dakota,ND,69416,57914,57914,0,11502,1443,10059,16.56966694,MU,38,38015
Burleson County,Texas,TX,16470,2660,0,2660,13810,1384,12426,83.84942319,MR,48,48051
Burlington County,New Jersey,NJ,423394,391644,354223,37421,31750,1289,30461,7.498925351,MU,34,34005
Burnet County,Texas,TX,34147,15480,0,15480,18667,1673,16994,54.66658857,MR,48,48053
Burnett County,Wisconsin,WI,15674,0,0,0,15674,678,14996,100,CR,55,55013
Burt County,Nebraska,NE,7791,0,0,0,7791,1199,6592,100,CR,31,31021
Butler County,Alabama,AL,21399,5287,0,5287,16112,469,15643,75.293238,MR,1,1013
Butler County,Iowa,IA,15305,0,0,0,15305,2080,13225,100,CR,19,19023
Butler County,Kansas,KS,59482,33229,7379,25850,26253,1854,24399,44.13604116,MU,20,20015
Butler County,Kentucky,KY,13010,0,0,0,13010,902,12108,100,CR,21,21031
Butler County,Missouri,MO,40867,19203,0,19203,21664,1012,20652,53.01098686,MR,29,29023
Butler County,Nebraska,NE,8767,2586,0,2586,6181,1506,4675,70.5030227,MR,31,31023
Butler County,Ohio,OH,332807,294890,272856,22034,37917,1838,36079,11.39308969,MU,39,39017
Butler County,Pennsylvania,PA,174083,92776,33442,59334,81307,1573,79734,46.70588168,MU,42,42019
Butte County,California,CA,203171,166740,89349,77391,36431,2120,34311,17.93120081,MU,6,6007
Butte County,Idaho,ID,2899,0,0,0,2899,441,2458,100,CR,16,16023
Butte County,South Dakota,SD,9094,4353,0,4353,4741,1144,3597,52.13327469,MR,46,46019
Butts County,Georgia,GA,19522,4411,0,4411,15111,190,14921,77.404979,MR,13,13035
Cabarrus County,North Carolina,NC,131063,94944,94944,0,36119,875,35244,27.5585024,MU,37,37025
Cabell County,West Virginia,WV,96784,74461,74461,0,22323,260,22063,23.06476277,MU,54,54011
Cache County,Utah,UT,91391,76141,76141,0,15250,1138,14112,16.68654463,MU,49,49005
Caddo County,Oklahoma,OK,30150,5768,0,5768,24382,1601,22781,80.86898839,MR,40,40015
Caddo Parish,Louisiana,LA,252161,212127,208664,3463,40034,539,39495,15.8763647,MU,22,22017
Calaveras County,California,CA,40554,7337,0,7337,33217,653,32564,81.90807319,MR,6,6009
Calcasieu Parish,Louisiana,LA,183577,142370,132937,9433,41207,374,40833,22.44671173,MU,22,22019
Caldwell County,Kentucky,KY,13060,6347,0,6347,6713,760,5953,51.40122511,MR,21,21033
Caldwell County,Missouri,MO,8969,0,0,0,8969,1255,7714,100,CR,29,29025
Caldwell County,North Carolina,NC,77415,47758,47758,0,29657,240,29417,38.30911322,MU,37,37027
Caldwell County,Texas,TX,32194,17443,0,17443,14751,1099,13652,45.81909673,MU,48,48055
Caldwell Parish,Louisiana,LA,10560,0,0,0,10560,208,10352,100,CR,22,22021
Caledonia County,Vermont,VT,29702,7287,0,7287,22415,824,21591,75.46629857,MR,50,50005
Calhoun County,Alabama,AL,112249,77606,73480,4126,34643,681,33962,30.86263575,MU,1,1015
Calhoun County,Arkansas,AR,5744,0,0,0,5744,20,5724,100,CR,5,5013
Calhoun County,Florida,FL,13017,4485,0,4485,8532,243,8289,65.54505646,MR,12,12013
Calhoun County,Georgia,GA,6320,0,0,0,6320,148,6172,100,CR,13,13037
Calhoun County,Illinois,IL,5084,0,0,0,5084,773,4311,100,CR,17,17013
Calhoun County,Iowa,IA,11115,0,0,0,11115,1435,9680,100,CR,19,19025
Calhoun County,Michigan,MI,137985,96162,79100,17062,41823,1830,39993,30.30981628,MU,26,26025
Calhoun County,Mississippi,MS,15069,2690,0,2690,12379,643,11736,82.14878227,MR,28,28013
Calhoun County,South Carolina,SC,15185,0,0,0,15185,681,14504,100,CR,45,45017
Calhoun County,Texas,TX,20647,12015,0,12015,8632,292,8340,41.80752652,MU,48,48057
Calhoun County,West Virginia,WV,7582,0,0,0,7582,276,7306,100,CR,54,54013
Callahan County,Texas,TX,12905,3397,0,3397,9508,583,8925,73.67686943,MR,48,48059
Callaway County,Missouri,MO,40766,15432,4011,11421,25334,1899,23435,62.14492469,MR,29,29027
Calloway County,Kentucky,KY,34177,16253,0,16253,17924,1676,16248,52.4446265,MR,21,21035
Calumet County,Wisconsin,WI,40631,24539,14936,9603,16092,1683,14409,39.60522754,MU,55,55015
Calvert County,Maryland,MD,74563,40328,0,40328,34235,665,33570,45.91419337,MU,24,24009
Camas County,Idaho,ID,991,0,0,0,991,134,857,100,CR,16,16025
Cambria County,Pennsylvania,PA,152598,103128,69256,33872,49470,543,48927,32.41851138,MU,42,42021
Camden County,Georgia,GA,43664,28020,0,28020,15644,121,15523,35.82814218,MU,13,13039
Camden County,Missouri,MO,37051,3038,0,3038,34013,705,33308,91.80049121,MR,29,29029
Camden County,New Jersey,NJ,508932,505297,505276,21,3635,77,3558,0.714240802,MU,34,34007
Camden County,North Carolina,NC,6885,0,0,0,6885,285,6600,100,CR,37,37029
Cameron County,Pennsylvania,PA,5974,3371,0,3371,2603,30,2573,43.57214597,MU,42,42023
Cameron County,Texas,TX,335227,292814,277197,15617,42413,1156,41257,12.65202385,MU,48,48061
Cameron Parish,Louisiana,LA,9991,0,0,0,9991,207,9784,100,CR,22,22023
Camp County,Texas,TX,11549,4597,0,4597,6952,583,6369,60.19568794,MR,48,48063
Campbell County,Kentucky,KY,88616,74693,74693,0,13923,609,13314,15.71160964,MU,21,21037
Campbell County,South Dakota,SD,1782,0,0,0,1782,515,1267,100,CR,46,46021
Campbell County,Tennessee,TN,39854,17478,0,17478,22376,390,21986,56.14492899,MR,47,47013
Campbell County,Virginia,VA,51078,19547,16066,3481,31531,1137,30394,61.73107796,MR,51,51031
Campbell County,Wyoming,WY,33698,20714,0,20714,12984,646,12338,38.53047659,MU,56,56005
Canadian County,Oklahoma,OK,87697,67157,52496,14661,20540,1555,18985,23.42155376,MU,40,40017
Candler County,Georgia,GA,9577,2667,0,2667,6910,446,6464,72.15203091,MR,13,13043
Cannon County,Tennessee,TN,12826,0,0,0,12826,721,12105,100,CR,47,47015
Canyon County,Idaho,ID,131441,96369,96369,0,35072,3297,31775,26.68269414,MU,16,16027
Cape Girardeau County,Missouri,MO,68693,46335,0,46335,22358,1722,20636,32.54771229,MU,29,29031
Cape May County,New Jersey,NJ,102326,85089,85089,0,17237,183,17054,16.84518109,MU,34,34009
Carbon County,Montana,MT,9552,0,0,0,9552,1182,8370,100,CR,30,30009
Carbon County,Pennsylvania,PA,58802,29109,18331,10778,29693,334,29359,50.49658175,MR,42,42025
Carbon County,Utah,UT,20422,12433,0,12433,7989,114,7875,39.11957693,MU,49,49007
Carbon County,Wyoming,WY,15639,8965,0,8965,6674,332,6342,42.67536287,MU,56,56007
Caribou County,Idaho,ID,7304,3060,0,3060,4244,397,3847,58.10514786,MR,16,16029
Carlisle County,Kentucky,KY,5351,0,0,0,5351,451,4900,100,CR,21,21039
Carlton County,Minnesota,MN,31671,11639,0,11639,20032,656,19376,63.25029207,MR,27,27017
Caroline County,Maryland,MD,29772,6369,0,6369,23403,1105,22298,78.60741636,MR,24,24011
Caroline County,Virginia,VA,22121,0,0,0,22121,664,21457,100,CR,51,51033
Carroll County,Arkansas,AR,25357,7198,0,7198,18159,1544,16615,71.6133612,MR,5,5015
Carroll County,Georgia,GA,87268,41158,0,41158,46110,1200,44910,52.83723702,MR,13,13045
Carroll County,Illinois,IL,16674,3537,0,3537,13137,1086,12051,78.78733357,MR,17,17015
Carroll County,Indiana,IN,20165,3968,0,3968,16197,1309,14888,80.32234069,MR,18,18015
Carroll County,Iowa,IA,21421,9908,0,9908,11513,2306,9207,53.7463237,MR,19,19027
Carroll County,Kentucky,KY,10155,4977,0,4977,5178,404,4774,50.98966027,MR,21,21041
Carroll County,Maryland,MD,150897,85837,64829,21008,65060,1985,63075,43.11550263,MU,24,24013
Carroll County,Mississippi,MS,10769,0,0,0,10769,341,10428,100,CR,28,28015
Carroll County,Missouri,MO,10285,3464,0,3464,6821,1367,5454,66.31988333,MR,29,29033
Carroll County,New Hampshire,NH,43666,0,0,0,43666,290,43376,100,CR,33,33003
Carroll County,Ohio,OH,28836,8994,0,8994,19842,904,18938,68.80982106,MR,39,39019
Carroll County,Tennessee,TN,29475,4957,0,4957,24518,1126,23392,83.18235793,MR,47,47017
Carroll County,Virginia,VA,29245,422,0,422,28823,812,28011,98.55701829,MR,51,51035
Carson City,Nevada,NV,52457,49316,49316,0,3141,0,3141,5.987761405,MU,32,32510
Carson County,Texas,TX,6516,233,0,233,6283,300,5983,96.42418662,MR,48,48065
Carter County,Kentucky,KY,26889,4783,0,4783,22106,1178,20928,82.21205697,MR,21,21043
Carter County,Missouri,MO,5941,0,0,0,5941,166,5775,100,CR,29,29035
Carter County,Montana,MT,1360,0,0,0,1360,518,842,100,CR,30,30011
Carter County,Oklahoma,OK,45621,20417,0,20417,25204,1046,24158,55.24648736,MR,40,40019
Carter County,Tennessee,TN,56742,34081,34081,0,22661,552,22109,39.93690741,MU,47,47019
Carteret County,North Carolina,NC,59383,36801,0,36801,22582,193,22389,38.02771837,MU,37,37031
Carver County,Minnesota,MN,70205,54282,41587,12695,15923,1802,14121,22.68072075,MU,27,27019
Cascade County,Montana,MT,80357,64416,64416,0,15941,1391,14550,19.83772416,MU,30,30013
Casey County,Kentucky,KY,15447,0,0,0,15447,2127,13320,100,CR,21,21045
Cass County,Illinois,IL,13695,6155,0,6155,7540,634,6906,55.05659,MR,17,17017
Cass County,Indiana,IN,40930,21929,0,21929,19001,1736,17265,46.4231615,MU,18,18017
Cass County,Iowa,IA,14684,6883,0,6883,7801,1274,6527,53.12585127,MR,19,19029
Cass County,Michigan,MI,51104,11598,5288,6310,39506,1501,38005,77.30510332,MR,26,26027
Cass County,Minnesota,MN,27150,0,0,0,27150,1125,26025,100,CR,27,27021
Cass County,Missouri,MO,82092,51377,34918,16459,30715,2039,28676,37.41533889,MU,29,29037
Cass County,Nebraska,NE,24334,7149,0,7149,17185,1471,15714,70.62135284,MR,31,31025
Cass County,North Dakota,ND,123138,106575,106575,0,16563,1499,15064,13.45076256,MU,38,38017
Cass County,Texas,TX,30438,5705,0,5705,24733,825,23908,81.2569814,MR,48,48067
Cassia County,Idaho,ID,21416,9396,0,9396,12020,1405,10615,56.12626074,MR,16,16031
Castro County,Texas,TX,8285,4297,0,4297,3988,659,3329,48.13518407,MU,48,48069
Caswell County,North Carolina,NC,23501,0,0,0,23501,879,22622,100,CR,37,37033
Catahoula Parish,Louisiana,LA,10920,0,0,0,10920,364,10556,100,CR,22,22025
Catawba County,North Carolina,NC,141685,92013,88811,3202,49672,1025,48647,35.05805131,MU,37,37035
Catoosa County,Georgia,GA,53282,37823,37823,0,15459,468,14991,29.01355054,MU,13,13047
Catron County,New Mexico,NM,3543,0,0,0,3543,173,3370,100,CR,35,35003
Cattaraugus County,New York,NY,83955,34860,0,34860,49095,1805,47290,58.47775594,MR,36,36009
Cavalier County,North Dakota,ND,4831,0,0,0,4831,368,4463,100,CR,38,38019
Cayuga County,New York,NY,81963,38842,0,38842,43121,2070,41051,52.61032417,MR,36,36011
Cecil County,Maryland,MD,85951,41147,29175,11972,44804,870,43934,52.1273749,MR,24,24015
Cedar County,Iowa,IA,18187,3009,0,3009,15178,1763,13415,83.45521526,MR,19,19031
Cedar County,Missouri,MO,13733,3583,0,3583,10150,1233,8917,73.90956091,MR,29,29039
Cedar County,Nebraska,NE,9615,0,0,0,9615,2111,7504,100,CR,31,31027
Centre County,Pennsylvania,PA,135758,87248,71358,15890,48510,1391,47119,35.73270084,MU,42,42027
Cerro Gordo County,Iowa,IA,46447,36559,0,36559,9888,1509,8379,21.28878076,MU,19,19033
Chaffee County,Colorado,CO,16242,10073,0,10073,6169,200,5969,37.98177564,MU,8,8015
Chambers County,Alabama,AL,36583,18418,0,18418,18165,331,17834,49.65421097,MU,1,1017
Chambers County,Texas,TX,26031,9322,3728,5594,16709,271,16438,64.18885175,MR,48,48071
Champaign County,Illinois,IL,179669,151539,123885,27654,28130,2092,26038,15.65656847,MU,17,17019
Champaign County,Ohio,OH,38890,11588,0,11588,27302,2342,24960,70.20313705,MR,39,39021
Chariton County,Missouri,MO,8438,0,0,0,8438,1711,6727,100,CR,29,29041
Charles City County,Virginia,VA,6926,0,0,0,6926,327,6599,100,CR,51,51036
Charles County,Maryland,MD,120546,79902,71989,7913,40644,1413,39231,33.71658952,MU,24,24017
Charles Mix County,South Dakota,SD,9350,0,0,0,9350,1459,7891,100,CR,46,46023
Charleston County,South Carolina,SC,309969,267629,267629,0,42340,922,41418,13.65943046,MU,45,45019
Charlevoix County,Michigan,MI,26090,8005,0,8005,18085,282,17803,69.31774626,MR,26,26029
Charlotte County,Florida,FL,141627,128324,128324,0,13303,135,13168,9.392982976,MU,12,12015
Charlotte County,Virginia,VA,12472,0,0,0,12472,863,11609,100,CR,51,51037
Charlottesville city,Virginia,VA,45049,45049,45049,0,0,0,0,0,MU,51,51540
Charlton County,Georgia,GA,10282,3950,0,3950,6332,114,6218,61.58334954,MR,13,13049
Chase County,Kansas,KS,3030,0,0,0,3030,378,2652,100,CR,20,20017
Chase County,Nebraska,NE,4068,0,0,0,4068,456,3612,100,CR,31,31029
Chatham County,Georgia,GA,232048,219227,208885,10342,12821,129,12692,5.525149969,MU,13,13051
Chatham County,North Carolina,NC,49329,9504,1855,7649,39825,1440,38385,80.7334428,MR,37,37037
Chattahoochee County,Georgia,GA,14882,11703,11703,0,3179,31,3148,21.36137616,MU,13,13053
Chattooga County,Georgia,GA,25470,11143,0,11143,14327,415,13912,56.25049077,MR,13,13055
Chautauqua County,Kansas,KS,4359,0,0,0,4359,535,3824,100,CR,20,20019
Chautauqua County,New York,NY,139750,82187,0,82187,57563,2399,55164,41.18998211,MU,36,36013
Chaves County,New Mexico,NM,61382,47158,0,47158,14224,1044,13180,23.17291714,MU,35,35005
Cheatham County,Tennessee,TN,35912,2432,0,2432,33480,735,32745,93.2278904,MR,47,47021
Cheboygan County,Michigan,MI,26448,4929,0,4929,21519,447,21072,81.36343013,MR,26,26031
Chelan County,Washington,WA,66616,41299,32830,8469,25317,2101,23216,38.00438333,MU,53,53007
Chemung County,New York,NY,91070,67224,67224,0,23846,412,23434,26.18425387,MU,36,36015
Chenango County,New York,NY,51401,8740,0,8740,42661,1521,41140,82.99643976,MR,36,36017
Cherokee County,Alabama,AL,23988,0,0,0,23988,608,23380,100,CR,1,1019
Cherokee County,Georgia,GA,141903,106079,106079,0,35824,809,35015,25.24541412,MU,13,13057
Cherokee County,Iowa,IA,13035,4984,0,4984,8051,1833,6218,61.76448025,MR,19,19035
Cherokee County,Kansas,KS,22605,11079,0,11079,11526,1264,10262,50.98871931,MR,20,20021
Cherokee County,North Carolina,NC,24298,0,0,0,24298,312,23986,100,CR,37,37039
Cherokee County,Oklahoma,OK,42521,17030,0,17030,25491,1241,24250,59.94920157,MR,40,40021
Cherokee County,South Carolina,SC,52537,20307,260,20047,32230,520,31710,61.34724099,MR,45,45021
Cherokee County,Texas,TX,46659,18215,0,18215,28444,1418,27026,60.96144367,MR,48,48073
Cherry County,Nebraska,NE,6148,2709,0,2709,3439,1081,2358,55.93689005,MR,31,31031
Chesapeake city,Virginia,VA,199184,179359,179359,0,19825,529,19296,9.953108683,MU,51,51550
Cheshire County,New Hampshire,NH,73825,24961,0,24961,48864,423,48441,66.18896038,MR,33,33005
Chester County,Pennsylvania,PA,433501,351068,337381,13687,82433,2732,79701,19.01564241,MU,42,42029
Chester County,South Carolina,SC,34068,11140,0,11140,22928,587,22341,67.30069273,MR,45,45023
Chester County,Tennessee,TN,15540,5244,0,5244,10296,342,9954,66.25482625,MR,47,47023
Chesterfield County,South Carolina,SC,42768,11732,0,11732,31036,1053,29983,72.56827535,MR,45,45025
Chesterfield County,Virginia,VA,259903,232604,232604,0,27299,237,27062,10.50353401,MU,51,51041
Cheyenne County,Colorado,CO,2231,0,0,0,2231,416,1815,100,CR,8,8017
Cheyenne County,Kansas,KS,3165,0,0,0,3165,485,2680,100,CR,20,20023
Cheyenne County,Nebraska,NE,9830,6114,0,6114,3716,785,2931,37.80264496,MU,31,31033
Chickasaw County,Iowa,IA,13095,3366,0,3366,9729,1745,7984,74.29553265,MR,19,19037
Chickasaw County,Mississippi,MS,19440,3225,0,3225,16215,429,15786,83.41049383,MR,28,28017
Chicot County,Arkansas,AR,14117,8745,0,8745,5372,309,5063,38.05341078,MU,5,5017
Childress County,Texas,TX,7688,5105,0,5105,2583,132,2451,33.59781478,MU,48,48075
Chilton County,Alabama,AL,39593,4776,0,4776,34817,801,34016,87.93726164,MR,1,1021
Chippewa County,Michigan,MI,38543,21301,0,21301,17242,467,16775,44.73445243,MU,26,26033
Chippewa County,Minnesota,MN,13088,6322,0,6322,6766,1427,5339,51.69621027,MR,27,27023
Chippewa County,Wisconsin,WI,55195,26260,19675,6585,28935,3119,25816,52.42322674,MR,55,55017
Chisago County,Minnesota,MN,41101,14611,0,14611,26490,1344,25146,64.45098659,MR,27,27025
Chittenden County,Vermont,VT,146571,105573,105573,0,40998,1027,39971,27.97142682,MU,50,50007
Choctaw County,Alabama,AL,15922,0,0,0,15922,486,15436,100,CR,1,1023
Choctaw County,Mississippi,MS,9758,0,0,0,9758,313,9445,100,CR,28,28019
Choctaw County,Oklahoma,OK,15342,5330,0,5330,10012,1001,9011,65.25876678,MR,40,40023
Chouteau County,Montana,MT,5970,0,0,0,5970,1173,4797,100,CR,30,30015
Chowan County,North Carolina,NC,14526,5421,0,5421,9105,118,8987,62.68071045,MR,37,37041
Christian County,Illinois,IL,35372,20040,0,20040,15332,1364,13968,43.34501866,MU,17,17021
Christian County,Kentucky,KY,72265,52471,21484,30987,19794,2326,17468,27.39085311,MU,21,21047
Christian County,Missouri,MO,54285,26770,26698,72,27515,1529,25986,50.68619324,MR,29,29043
Churchill County,Nevada,NV,23982,15579,0,15579,8403,810,7593,35.03877908,MU,32,32001
Cibola County,New Mexico,NM,25595,10279,0,10279,15316,194,15122,59.83981246,MR,35,35006
Cimarron County,Oklahoma,OK,3148,0,0,0,3148,467,2681,100,CR,40,40025
Citrus County,Florida,FL,118085,68316,0,68316,49769,304,49465,42.14675869,MU,12,12017
Clackamas County,Oregon,OR,338391,266559,234914,31645,71832,6990,64842,21.22751492,MU,41,41005
Claiborne County,Mississippi,MS,11831,2996,0,2996,8835,149,8686,74.67669681,MR,28,28021
Claiborne County,Tennessee,TN,29862,8920,0,8920,20942,1610,19332,70.12926127,MR,47,47025
Claiborne Parish,Louisiana,LA,16851,3735,0,3735,13116,339,12777,77.83514331,MR,22,22027
Clallam County,Washington,WA,64525,33711,0,33711,30814,410,30404,47.75513367,MU,53,53009
Clare County,Michigan,MI,31252,6934,0,6934,24318,512,23806,77.81261999,MR,26,26035
Clarendon County,South Carolina,SC,32502,4772,0,4772,27730,1002,26728,85.3178266,MR,45,45027
Clarion County,Pennsylvania,PA,41765,8953,0,8953,32812,694,32118,78.5633904,MR,42,42031
Clark County,Arkansas,AR,23546,10417,0,10417,13129,367,12762,55.75893995,MR,5,5019
Clark County,Idaho,ID,1022,0,0,0,1022,80,942,100,CR,16,16033
Clark County,Illinois,IL,17008,7066,0,7066,9942,1088,8854,58.45484478,MR,17,17023
Clark County,Indiana,IN,96472,73790,66890,6900,22682,1146,21536,23.5114852,MU,18,18019
Clark County,Kansas,KS,2390,0,0,0,2390,271,2119,100,CR,20,20025
Clark County,Kentucky,KY,33144,22085,0,22085,11059,1204,9855,33.36652184,MU,21,21049
Clark County,Missouri,MO,7416,0,0,0,7416,1183,6233,100,CR,29,29045
Clark County,Nevada,NV,1375765,1344370,1314296,30074,31395,21,31374,2.282003104,MU,32,32003
Clark County,Ohio,OH,144742,110358,104496,5862,34384,1567,32817,23.75537163,MU,39,39023
Clark County,South Dakota,SD,4143,0,0,0,4143,1056,3087,100,CR,46,46025
Clark County,Washington,WA,345238,284607,284266,341,60631,1669,58962,17.5620876,MU,53,53011
Clark County,Wisconsin,WI,33557,2465,0,2465,31092,5519,25573,92.65428972,MR,55,55019
Clarke County,Alabama,AL,27867,7137,0,7137,20730,307,20423,74.38906233,MR,1,1025
Clarke County,Georgia,GA,101489,92622,92622,0,8867,99,8768,8.736907448,MU,13,13059
Clarke County,Iowa,IA,9133,4375,0,4375,4758,1210,3548,52.09679185,MR,19,19039
Clarke County,Mississippi,MS,17955,0,0,0,17955,408,17547,100,CR,28,28023
Clarke County,Virginia,VA,12652,2990,0,2990,9662,393,9269,76.36737275,MR,51,51043
Clatsop County,Oregon,OR,35630,20994,0,20994,14636,386,14250,41.07774347,MU,41,41007
Clay County,Alabama,AL,14254,0,0,0,14254,477,13777,100,CR,1,1027
Clay County,Arkansas,AR,17609,6725,0,6725,10884,981,9903,61.80930206,MR,5,5021
Clay County,Florida,FL,140814,105702,92097,13605,35112,302,34810,24.93502067,MU,12,12019
Clay County,Georgia,GA,3357,0,0,0,3357,107,3250,100,CR,13,13061
Clay County,Illinois,IL,14560,4924,0,4924,9636,1228,8408,66.18131868,MR,17,17025
Clay County,Indiana,IN,26556,10074,0,10074,16482,982,15500,62.06507004,MR,18,18021
Clay County,Iowa,IA,17372,10989,0,10989,6383,1344,5039,36.74303477,MU,19,19041
Clay County,Kansas,KS,8822,4454,0,4454,4368,843,3525,49.51258218,MU,20,20027
Clay County,Kentucky,KY,24556,4687,0,4687,19869,568,19301,80.91301515,MR,21,21051
Clay County,Minnesota,MN,51229,35882,35882,0,15347,1495,13852,29.95764118,MU,27,27027
Clay County,Mississippi,MS,21979,9500,0,9500,12479,654,11825,56.77692343,MR,28,28025
Clay County,Missouri,MO,184006,164527,144559,19968,19479,625,18854,10.58606785,MU,29,29047
Clay County,Nebraska,NE,7039,0,0,0,7039,788,6251,100,CR,31,31035
Clay County,North Carolina,NC,8775,0,0,0,8775,206,8569,100,CR,37,37043
Clay County,South Dakota,SD,13537,10160,0,10160,3377,1057,2320,24.94644308,MU,46,46027
Clay County,Tennessee,TN,7976,0,0,0,7976,978,6998,100,CR,47,47027
Clay County,Texas,TX,11006,2966,0,2966,8040,719,7321,73.05106306,MR,48,48077
Clay County,West Virginia,WV,10330,0,0,0,10330,121,10209,100,CR,54,54015
Clayton County,Georgia,GA,236517,233596,233596,0,2921,122,2799,1.235006363,MU,13,13063
Clayton County,Iowa,IA,18678,866,0,866,17812,3236,14576,95.36352929,MR,19,19043
Clear Creek County,Colorado,CO,9322,201,0,201,9121,38,9083,97.84381034,MR,8,8019
Clearfield County,Pennsylvania,PA,83382,38311,0,38311,45071,475,44596,54.05363268,MR,42,42033
Clearwater County,Idaho,ID,8930,3922,0,3922,5008,240,4768,56.0806271,MR,16,16035
Clearwater County,Minnesota,MN,8423,0,0,0,8423,848,7575,100,CR,27,27029
Cleburne County,Alabama,AL,14123,0,0,0,14123,436,13687,100,CR,1,1029
Cleburne County,Arkansas,AR,24046,5420,0,5420,18626,619,18007,77.45986859,MR,5,5023
Clermont County,Ohio,OH,177977,126808,123675,3133,51169,1653,49516,28.75034415,MU,39,39025
Cleveland County,Arkansas,AR,8571,0,0,0,8571,341,8230,100,CR,5,5025
Cleveland County,North Carolina,NC,96287,42838,0,42838,53449,973,52476,55.51008963,MR,37,37045
Cleveland County,Oklahoma,OK,208016,165777,163753,2024,42239,1282,40957,20.30564957,MU,40,40027
Clifton Forge city,Virginia,VA,4289,4289,0,4289,0,0,0,0,MU,51,51560
Clinch County,Georgia,GA,6878,2876,0,2876,4002,136,3866,58.18551905,MR,13,13065
Clinton County,Illinois,IL,35535,20824,0,20824,14711,1506,13205,41.39862108,MU,17,17027
Clinton County,Indiana,IN,33866,16877,0,16877,16989,1115,15874,50.16535759,MR,18,18023
Clinton County,Iowa,IA,50149,34129,0,34129,16020,2627,13393,31.94480448,MU,19,19045
Clinton County,Kentucky,KY,9634,0,0,0,9634,1218,8416,100,CR,21,21053
Clinton County,Michigan,MI,64753,25554,17936,7618,39199,2575,36624,60.53619137,MR,26,26037
Clinton County,Missouri,MO,18979,4301,0,4301,14678,1296,13382,77.33811054,MR,29,29049
Clinton County,New York,NY,79894,31046,0,31046,48848,1024,47824,61.14101184,MR,36,36019
Clinton County,Ohio,OH,40543,18167,0,18167,22376,1973,20403,55.19078509,MR,39,39027
Clinton County,Pennsylvania,PA,37914,18662,0,18662,19252,462,18790,50.7780767,MR,42,42035
Cloud County,Kansas,KS,10268,5636,0,5636,4632,770,3862,45.11102454,MU,20,20029
Coahoma County,Mississippi,MS,30622,20788,0,20788,9834,274,9560,32.11416629,MU,28,28027
Coal County,Oklahoma,OK,6031,0,0,0,6031,618,5413,100,CR,40,40029
Cobb County,Georgia,GA,607751,604762,604762,0,2989,38,2951,0.491813259,MU,13,13067
Cochise County,Arizona,AZ,117755,78163,0,78163,39592,1240,38352,33.62235149,MU,4,4003
Cochran County,Texas,TX,3730,0,0,0,3730,160,3570,100,CR,48,48079
Cocke County,Tennessee,TN,33565,10918,0,10918,22647,860,21787,67.47206912,MR,47,47029
Coconino County,Arizona,AZ,116320,74462,57124,17338,41858,378,41480,35.9852132,MU,4,4005
Codington County,South Dakota,SD,25897,19625,0,19625,6272,1378,4894,24.21902151,MU,46,46029
Coffee County,Alabama,AL,43615,19440,0,19440,24175,877,23298,55.42817838,MR,1,1031
Coffee County,Georgia,GA,37413,12371,0,12371,25042,812,24230,66.93395344,MR,13,13069
Coffee County,Tennessee,TN,48014,25175,0,25175,22839,1140,21699,47.56737618,MU,47,47031
Coffey County,Kansas,KS,8865,2739,0,2739,6126,806,5320,69.10321489,MR,20,20031
Coke County,Texas,TX,3864,0,0,0,3864,204,3660,100,CR,48,48081
Colbert County,Alabama,AL,54984,29102,28715,387,25882,804,25078,47.07187545,MU,1,1033
Cole County,Missouri,MO,71397,49547,49547,0,21850,1357,20493,30.60352676,MU,29,29051
Coleman County,Texas,TX,9235,4669,0,4669,4566,576,3990,49.44233893,MU,48,48083
Coles County,Illinois,IL,53196,40447,0,40447,12749,1352,11397,23.96608768,MU,17,17029
Colfax County,Nebraska,NE,10441,5270,0,5270,5171,1126,4045,49.52590748,MU,31,31037
Colfax County,New Mexico,NM,14189,6789,0,6789,7400,320,7080,52.15307633,MR,35,35007
Colleton County,South Carolina,SC,38264,10034,0,10034,28230,761,27469,73.77691825,MR,45,45029
Collier County,Florida,FL,251377,225452,188543,36909,25925,414,25511,10.31319492,MU,12,12021
Collin County,Texas,TX,491675,441988,435750,6238,49687,1476,48211,10.10565923,MU,48,48085
Collingsworth County,Texas,TX,3206,0,0,0,3206,217,2989,100,CR,48,48087
Colonial Heights city,Virginia,VA,16897,16897,16897,0,0,0,0,0,MU,51,51570
Colorado County,Texas,TX,20390,8067,0,8067,12323,1257,11066,60.43648847,MR,48,48089
Colquitt County,Georgia,GA,42053,15335,0,15335,26718,1271,25447,63.53411172,MR,13,13071
Columbia County,Arkansas,AR,25603,10450,0,10450,15153,421,14732,59.18447057,MR,5,5027
Columbia County,Florida,FL,56513,18208,0,18208,38305,769,37536,67.78086458,MR,12,12023
Columbia County,Georgia,GA,89288,65864,65864,0,23424,415,23009,26.2342084,MU,13,13073
Columbia County,New York,NY,63094,18544,0,18544,44550,1007,43543,70.6089327,MR,36,36021
Columbia County,Oregon,OR,43560,22907,1655,21252,20653,1211,19442,47.412764,MU,41,41009
Columbia County,Pennsylvania,PA,64151,35730,0,35730,28421,1116,27305,44.30328444,MU,42,42037
Columbia County,Washington,WA,4064,2729,0,2729,1335,288,1047,32.84940945,MU,53,53013
Columbia County,Wisconsin,WI,52468,19290,0,19290,33178,2826,30352,63.23473355,MR,55,55021
Columbiana County,Ohio,OH,112075,63642,0,63642,48433,2119,46314,43.21481151,MU,39,39029
Columbus County,North Carolina,NC,54749,6406,0,6406,48343,1738,46605,88.29932967,MR,37,37047
Colusa County,California,CA,18804,9595,0,9595,9209,970,8239,48.97362263,MU,6,6011
Comal County,Texas,TX,78021,44457,1519,42938,33564,638,32926,43.01918714,MU,48,48091
Comanche County,Kansas,KS,1967,0,0,0,1967,273,1694,100,CR,20,20033
Comanche County,Oklahoma,OK,114996,89757,89757,0,25239,1255,23984,21.94771992,MU,40,40031
Comanche County,Texas,TX,14026,4203,0,4203,9823,1293,8530,70.03422216,MR,48,48093
Concho County,Texas,TX,3966,0,0,0,3966,335,3631,100,CR,48,48095
Concordia Parish,Louisiana,LA,20247,12502,0,12502,7745,413,7332,38.25258063,MU,22,22029
Conecuh County,Alabama,AL,14089,0,0,0,14089,392,13697,100,CR,1,1035
Conejos County,Colorado,CO,8400,0,0,0,8400,547,7853,100,CR,8,8021
Contra Costa County,California,CA,948816,928782,917057,11725,20034,544,19490,2.111473668,MU,6,6013
Converse County,Wyoming,WY,12052,5279,0,5279,6773,622,6151,56.19814139,MR,56,56009
Conway County,Arkansas,AR,20336,5612,0,5612,14724,824,13900,72.4036192,MR,5,5029
Cook County,Georgia,GA,15771,6474,0,6474,9297,431,8866,58.94997147,MR,13,13075
Cook County,Illinois,IL,5376741,5372154,5372154,0,4587,8,4579,0.085311902,MU,17,17031
Cook County,Minnesota,MN,5168,0,0,0,5168,17,5151,100,CR,27,27031
Cooke County,Texas,TX,36363,15407,0,15407,20956,1766,19190,57.63000853,MR,48,48097
Cooper County,Missouri,MO,16670,8198,0,8198,8472,1334,7138,50.82183563,MR,29,29053
Coos County,New Hampshire,NH,33111,11387,0,11387,21724,281,21443,65.60961614,MR,33,33007
Coos County,Oregon,OR,62779,39277,0,39277,23502,884,22618,37.43608532,MU,41,41011
Coosa County,Alabama,AL,12202,319,0,319,11883,413,11470,97.38567448,MR,1,1037
Copiah County,Mississippi,MS,28757,11818,0,11818,16939,813,16126,58.90391905,MR,28,28029
Corson County,South Dakota,SD,4181,0,0,0,4181,463,3718,100,CR,46,46031
Cortland County,New York,NY,48599,26681,0,26681,21918,866,21052,45.09969341,MU,36,36023
Coryell County,Texas,TX,74978,61855,46709,15146,13123,1062,12061,17.50246739,MU,48,48099
Coshocton County,Ohio,OH,36655,14950,0,14950,21705,1891,19814,59.21429546,MR,39,39031
Costilla County,Colorado,CO,3663,0,0,0,3663,147,3516,100,CR,8,8023
Cottle County,Texas,TX,1904,0,0,0,1904,142,1762,100,CR,48,48101
Cotton County,Oklahoma,OK,6614,2777,0,2777,3837,470,3367,58.01330511,MR,40,40033
Cottonwood County,Minnesota,MN,12167,4215,0,4215,7952,1441,6511,65.3571135,MR,27,27033
Covington city,Virginia,VA,6303,6303,0,6303,0,0,0,0,MU,51,51580
Covington County,Alabama,AL,37631,10550,0,10550,27081,850,26231,71.96460365,MR,1,1039
Covington County,Mississippi,MS,19407,0,0,0,19407,669,18738,100,CR,28,28031
Coweta County,Georgia,GA,89215,48569,24727,23842,40646,574,40072,45.55960321,MU,13,13077
Cowley County,Kansas,KS,36291,23789,0,23789,12502,1497,11005,34.4493125,MU,20,20035
Cowlitz County,Washington,WA,92948,62635,58896,3739,30313,607,29706,32.6128588,MU,53,53015
Craig County,Oklahoma,OK,14950,6387,0,6387,8563,1415,7148,57.27759197,MR,40,40035
Craig County,Virginia,VA,5091,0,0,0,5091,107,4984,100,CR,51,51045
Craighead County,Arkansas,AR,82148,53330,51820,1510,28818,879,27939,35.08058626,MU,5,5031
Crane County,Texas,TX,3996,3581,0,3581,415,0,415,10.38538539,MU,48,48103
Craven County,North Carolina,NC,91436,61981,0,61981,29455,508,28947,32.21378888,MU,37,37049
Crawford County,Arkansas,AR,53247,24022,19922,4100,29225,853,28372,54.88572126,MR,5,5033
Crawford County,Georgia,GA,12495,0,0,0,12495,342,12153,100,CR,13,13079
Crawford County,Illinois,IL,20452,8268,0,8268,12184,1335,10849,59.57363583,MR,17,17033
Crawford County,Indiana,IN,10743,0,0,0,10743,496,10247,100,CR,18,18025
Crawford County,Iowa,IA,16942,7152,0,7152,9790,2012,7778,57.78538543,MR,19,19047
Crawford County,Kansas,KS,38242,24280,0,24280,13962,1253,12709,36.50959678,MU,20,20037
Crawford County,Michigan,MI,14273,4270,0,4270,10003,86,9917,70.0833742,MR,26,26039
Crawford County,Missouri,MO,22804,4229,0,4229,18575,753,17822,81.45500789,MR,29,29055
Crawford County,Ohio,OH,46966,31174,0,31174,15792,1723,14069,33.62432398,MU,39,39033
Crawford County,Pennsylvania,PA,90366,31245,0,31245,59121,2180,56941,65.42394263,MR,42,42039
Crawford County,Wisconsin,WI,17243,6406,0,6406,10837,1929,8908,62.84869222,MR,55,55023
Creek County,Oklahoma,OK,67367,31046,20847,10199,36321,1301,35020,53.91512165,MR,40,40037
Crenshaw County,Alabama,AL,13665,0,0,0,13665,460,13205,100,CR,1,1041
Crisp County,Georgia,GA,21996,12910,0,12910,9086,353,8733,41.30751046,MU,13,13081
Crittenden County,Arkansas,AR,50866,40545,37781,2764,10321,270,10051,20.29056737,MU,5,5035
Crittenden County,Kentucky,KY,9384,2773,0,2773,6611,834,5777,70.44970162,MR,21,21055
Crockett County,Tennessee,TN,14532,0,0,0,14532,744,13788,100,CR,47,47033
Crockett County,Texas,TX,4099,3028,0,3028,1071,114,957,26.12832398,MU,48,48105
Crook County,Oregon,OR,19182,10245,0,10245,8937,1167,7770,46.59055364,MU,41,41013
Crook County,Wyoming,WY,5887,0,0,0,5887,675,5212,100,CR,56,56011
Crosby County,Texas,TX,7072,0,0,0,7072,398,6674,100,CR,48,48107
Cross County,Arkansas,AR,19526,8083,0,8083,11443,530,10913,58.60391273,MR,5,5037
Crow Wing County,Minnesota,MN,55099,20636,0,20636,34463,845,33618,62.54741465,MR,27,27035
Crowley County,Colorado,CO,5518,0,0,0,5518,385,5133,100,CR,8,8025
Culberson County,Texas,TX,2975,0,0,0,2975,44,2931,100,CR,48,48109
Cullman County,Alabama,AL,77483,18840,0,18840,58643,2967,55676,75.68498897,MR,1,1043
Culpeper County,Virginia,VA,34262,9707,0,9707,24555,753,23802,71.66832059,MR,51,51047
Cumberland County,Illinois,IL,11253,0,0,0,11253,965,10288,100,CR,17,17035
Cumberland County,Kentucky,KY,7147,0,0,0,7147,606,6541,100,CR,21,21057
Cumberland County,Maine,ME,265612,174473,149552,24921,91139,579,90560,34.31283225,MU,23,23005
Cumberland County,New Jersey,NJ,146438,117281,76419,40862,29157,1080,28077,19.9108155,MU,34,34011
Cumberland County,North Carolina,NC,302963,264583,264583,0,38380,740,37640,12.66821361,MU,37,37051
Cumberland County,Pennsylvania,PA,213674,159975,112771,47204,53699,2130,51569,25.13127475,MU,42,42041
Cumberland County,Tennessee,TN,46802,14547,0,14547,32255,1033,31222,68.91799496,MR,47,47035
Cumberland County,Virginia,VA,9017,349,0,349,8668,245,8423,96.1295331,MR,51,51049
Cuming County,Nebraska,NE,10203,3288,0,3288,6915,2102,4813,67.77418406,MR,31,31039
Currituck County,North Carolina,NC,18190,0,0,0,18190,162,18028,100,CR,37,37053
Curry County,New Mexico,NM,45044,38442,0,38442,6602,730,5872,14.65678004,MU,35,35009
Curry County,Oregon,OR,21137,9904,0,9904,11233,160,11073,53.14377632,MR,41,41015
Custer County,Colorado,CO,3503,0,0,0,3503,242,3261,100,CR,8,8027
Custer County,Idaho,ID,4342,0,0,0,4342,468,3874,100,CR,16,16037
Custer County,Montana,MT,11696,9703,0,9703,1993,657,1336,17.04001368,MU,30,30017
Custer County,Nebraska,NE,11793,3547,0,3547,8246,2246,6000,69.92283558,MR,31,31041
Custer County,Oklahoma,OK,26142,17980,0,17980,8162,742,7420,31.22178869,MU,40,40039
Custer County,South Dakota,SD,7275,0,0,0,7275,485,6790,100,CR,46,46033
Cuyahoga County,Ohio,OH,1393978,1383344,1383344,0,10634,10,10624,0.762852785,MU,39,39035
Dade County,Georgia,GA,15154,3059,660,2399,12095,283,11812,79.81391052,MR,13,12025
Dade County,Missouri,MO,7923,0,0,0,7923,1174,6749,100,CR,29,29057
Daggett County,Utah,UT,921,0,0,0,921,72,849,100,CR,49,49009
Dakota County,Minnesota,MN,355904,334361,315774,18587,21543,1640,19903,6.053036774,MU,27,27037
Dakota County,Nebraska,NE,20253,15888,15888,0,4365,487,3878,21.55236261,MU,31,31043
Dale County,Alabama,AL,49129,22191,2816,19375,26938,364,26574,54.83115879,MR,1,1045
Dallam County,Texas,TX,6222,4605,0,4605,1617,392,1225,25.98842816,MU,48,48111
Dallas County,Alabama,AL,46365,24434,0,24434,21931,950,20981,47.30076566,MU,1,1047
Dallas County,Arkansas,AR,9210,4145,0,4145,5065,70,4995,54.99457112,MR,5,5039
Dallas County,Iowa,IA,40750,21479,10768,10711,19271,1798,17473,47.29079755,MU,19,19049
Dallas County,Missouri,MO,15661,2650,0,2650,13011,1730,11281,83.07898602,MR,29,29059
Dallas County,Texas,TX,2218899,2198761,2194744,4017,20138,317,19821,0.907567221,MU,48,48113
Dane County,Wisconsin,WI,426526,360459,328995,31464,66067,5259,60808,15.48955984,MU,55,55025
Daniels County,Montana,MT,2017,0,0,0,2017,485,1532,100,CR,30,30019
Danville city,Virginia,VA,48411,45359,45359,0,3052,25,3027,6.304352317,MU,51,51590
Dare County,North Carolina,NC,29967,20864,0,20864,9103,8,9095,30.37674776,MU,37,37055
Darke County,Ohio,OH,53309,18252,0,18252,35057,5292,29765,65.76187886,MR,39,39037
Darlington County,South Carolina,SC,67394,30579,3198,27381,36815,695,36120,54.62652462,MR,45,45031
Dauphin County,Pennsylvania,PA,251798,214708,204584,10124,37090,872,36218,14.7300614,MU,42,42043
Davidson County,North Carolina,NC,147246,63429,37252,26177,83817,1384,82433,56.92310827,MR,37,37057
Davidson County,Tennessee,TN,569891,543955,543955,0,25936,486,25450,4.551045726,MU,47,47037
Davie County,North Carolina,NC,34835,7950,4182,3768,26885,843,26042,77.17812545,MR,37,37059
Daviess County,Indiana,IN,29820,12252,0,12252,17568,3167,14401,58.91348089,MR,18,18027
Daviess County,Kentucky,KY,91545,67557,67557,0,23988,2198,21790,26.20350647,MU,21,21059
Daviess County,Missouri,MO,8016,0,0,0,8016,1498,6518,100,CR,29,29061
Davis County,Iowa,IA,8541,0,0,0,8541,2093,6448,100,CR,19,19051
Davis County,Utah,UT,238994,234410,234410,0,4584,231,4353,1.918039783,MU,49,49011
Davison County,South Dakota,SD,18741,14535,0,14535,4206,934,3272,22.44277253,MU,46,46035
Dawes County,Nebraska,NE,9060,5423,0,5423,3637,788,2849,40.14348786,MU,31,31045
Dawson County,Georgia,GA,15999,0,0,0,15999,463,15536,100,CR,13,13085
Dawson County,Montana,MT,9059,6117,0,6117,2942,705,2237,32.47599073,MU,30,30021
Dawson County,Nebraska,NE,24365,17803,0,17803,6562,1191,5371,26.9320747,MU,31,31047
Dawson County,Texas,TX,14985,12290,0,12290,2695,360,2335,17.98465132,MU,48,48115
Day County,South Dakota,SD,6267,0,0,0,6267,965,5302,100,CR,46,46037
De Baca County,New Mexico,NM,2240,0,0,0,2240,306,1934,100,CR,35,35011
De Soto Parish,Louisiana,LA,25494,6740,0,6740,18754,477,18277,73.56240684,MR,22,22031
De Witt County,Illinois,IL,16798,8141,0,8141,8657,660,7997,51.53589713,MR,17,17039
Deaf Smith County,Texas,TX,18561,15294,0,15294,3267,769,2498,17.60142234,MU,48,48117
Dearborn County,Indiana,IN,46109,17123,4777,12346,28986,1005,27981,62.86408293,MR,18,18029
Decatur County,Georgia,GA,28240,11874,0,11874,16366,581,15785,57.95325779,MR,13,13087
Decatur County,Indiana,IN,24555,10385,0,10385,14170,1309,12861,57.70718795,MR,18,18031
Decatur County,Iowa,IA,8689,0,0,0,8689,1059,7630,100,CR,19,19053
Decatur County,Kansas,KS,3472,0,0,0,3472,419,3053,100,CR,20,20039
Decatur County,Tennessee,TN,11731,0,0,0,11731,354,11377,100,CR,47,47039
Deer Lodge County,Montana,MT,9417,6279,0,6279,3138,113,3025,33.32271424,MU,30,30023
Defiance County,Ohio,OH,39500,20718,0,20718,18782,1815,16967,47.54936709,MU,39,39039
DeKalb County,Alabama,AL,64452,7572,0,7572,56880,2747,54133,88.25172221,MR,1,1049
DeKalb County,Georgia,GA,665865,663192,663192,0,2673,0,2673,0.401432723,MU,13,13089
DeKalb County,Illinois,IL,88969,68781,55746,13035,20188,1997,18191,22.69104969,MU,17,17037
DeKalb County,Indiana,IN,40285,23395,0,23395,16890,1692,15198,41.92627529,MU,18,18033
DeKalb County,Missouri,MO,11597,3881,0,3881,7716,1188,6528,66.53444856,MR,29,29063
DeKalb County,Tennessee,TN,17423,3678,0,3678,13745,822,12923,78.88997302,MR,47,47041
Del Norte County,California,CA,27507,18667,0,18667,8840,49,8791,32.13727415,MU,6,6015
Delaware County,Indiana,IN,118769,90921,90921,0,27848,2224,25624,23.44719582,MU,18,18035
Delaware County,Iowa,IA,18404,5376,0,5376,13028,2951,10077,70.78895892,MR,19,19055
Delaware County,New York,NY,48055,7113,0,7113,40942,1265,39677,85.19821038,MR,36,36025
Delaware County,Ohio,OH,109989,74650,45518,29132,35339,1596,33743,32.12957659,MU,39,39041
Delaware County,Oklahoma,OK,37077,6332,0,6332,30745,1814,28931,82.92202713,MR,40,40041
Delaware County,Pennsylvania,PA,550864,544833,544833,0,6031,0,6031,1.094825583,MU,42,42045
Delta County,Colorado,CO,27834,6863,0,6863,20971,1668,19303,75.34310555,MR,8,8029
Delta County,Michigan,MI,38520,21117,0,21117,17403,269,17134,45.17912773,MU,26,26041
Delta County,Texas,TX,5327,0,0,0,5327,296,5031,100,CR,48,48119
Denali Borough,Alaska,AK,1893,0,0,0,1893,0,1893,100,CR,2,2068
Dent County,Missouri,MO,14927,5044,0,5044,9883,766,9117,66.20888323,MR,29,29065
Denton County,Texas,TX,432976,383057,370788,12269,49919,2392,47527,11.52927645,MU,48,48121
Denver County,Colorado,CO,554636,554632,554632,0,4,0,4,0.000721194,MU,8,8031
Des Moines County,Iowa,IA,42351,30283,0,30283,12068,1085,10983,28.49519492,MU,19,19057
Deschutes County,Oregon,OR,115367,72550,57376,15174,42817,1761,41056,37.1137327,MU,41,41017
Desha County,Arkansas,AR,15341,9915,0,9915,5426,293,5133,35.36927189,MU,5,5041
DeSoto County,Florida,FL,32209,14753,691,14062,17456,682,16774,54.19603216,MR,12,12027
DeSoto County,Mississippi,MS,107199,72428,65700,6728,34771,899,33872,32.4359369,MU,28,28033
Deuel County,Nebraska,NE,2098,0,0,0,2098,272,1826,100,CR,31,31049
Deuel County,South Dakota,SD,4498,0,0,0,4498,1102,3396,100,CR,46,46039
Dewey County,Oklahoma,OK,4743,0,0,0,4743,609,4134,100,CR,40,40043
Dewey County,South Dakota,SD,5972,0,0,0,5972,462,5510,100,CR,46,46041
DeWitt County,Texas,TX,20013,9442,0,9442,10571,1292,9279,52.82066657,MR,48,48123
Dickens County,Texas,TX,2762,0,0,0,2762,223,2539,100,CR,48,48125
Dickenson County,Virginia,VA,16395,0,0,0,16395,155,16240,100,CR,51,51051
Dickey County,North Dakota,ND,5757,0,0,0,5757,914,4843,100,CR,38,38021
Dickinson County,Iowa,IA,16424,11468,0,11468,4956,894,4062,30.17535314,MU,19,19059
Dickinson County,Kansas,KS,19344,6831,0,6831,12513,1682,10831,64.68672457,MR,20,20041
Dickinson County,Michigan,MI,27472,19863,0,19863,7609,191,7418,27.69729179,MU,26,26043
Dickson County,Tennessee,TN,43156,13453,0,13453,29703,1652,28051,68.82704607,MR,47,47043
Dillingham Census Area,Alaska,AK,4922,0,0,0,4922,15,4907,100,CR,2,2070
Dillon County,South Carolina,SC,30722,10544,0,10544,20178,648,19530,65.67931775,MR,45,45033
Dimmit County,Texas,TX,10248,6400,0,6400,3848,113,3735,37.54879001,MU,48,48127
Dinwiddie County,Virginia,VA,24533,6597,6597,0,17936,703,17233,73.10968899,MR,51,51053
District of Columbia,District of Columbia,DC,572059,572059,572059,0,0,0,0,0,MU,11,11001
Divide County,North Dakota,ND,2283,0,0,0,2283,570,1713,100,CR,38,38023
Dixie County,Florida,FL,13827,3348,0,3348,10479,123,10356,75.78650466,MR,12,12029
Dixon County,Nebraska,NE,6339,0,0,0,6339,964,5375,100,CR,31,31051
Doddridge County,West Virginia,WV,7403,0,0,0,7403,302,7101,100,CR,54,54017
Dodge County,Georgia,GA,19171,5581,0,5581,13590,481,13109,70.8883209,MR,13,13091
Dodge County,Minnesota,MN,17731,5507,0,5507,12224,1697,10527,68.94140206,MR,27,27039
Dodge County,Nebraska,NE,36160,25769,0,25769,10391,1352,9039,28.73617257,MU,31,31053
Dodge County,Wisconsin,WI,85897,41039,0,41039,44858,4253,40605,52.22301128,MR,55,55027
Dolores County,Colorado,CO,1844,0,0,0,1844,173,1671,100,CR,8,8033
Dona Ana County,New Mexico,NM,174682,139836,131125,8711,34846,1706,33140,19.94824882,MU,35,35013
Doniphan County,Kansas,KS,8249,997,997,0,7252,764,6488,87.91368651,MR,20,20043
Donley County,Texas,TX,3828,0,0,0,3828,325,3503,100,CR,48,48129
Dooly County,Georgia,GA,11525,2688,0,2688,8837,299,8538,76.67678959,MR,13,13093
Door County,Wisconsin,WI,27961,8784,0,8784,19177,1125,18052,68.58481456,MR,55,55029
Dorchester County,Maryland,MD,30674,12412,0,12412,18262,604,17658,59.53576319,MR,24,24019
Dorchester County,South Carolina,SC,96413,70344,70344,0,26069,402,25667,27.0388848,MU,45,45035
Dougherty County,Georgia,GA,96065,83139,83139,0,12926,335,12591,13.45547286,MU,13,13095
Douglas County,Colorado,CO,175766,150635,120999,29636,25131,622,24509,14.2979871,MU,8,8035
Douglas County,Georgia,GA,92174,73665,73605,60,18509,0,18509,20.08049992,MU,13,13097
Douglas County,Illinois,IL,19922,7310,0,7310,12612,1338,11274,63.3068969,MR,17,17041
Douglas County,Kansas,KS,99962,87182,79620,7562,12780,1500,11280,12.78485825,MU,20,20045
Douglas County,Minnesota,MN,32821,13908,0,13908,18913,1973,16940,57.62469151,MR,27,27041
Douglas County,Missouri,MO,13084,2816,0,2816,10268,1657,8611,78.47752981,MR,29,29067
Douglas County,Nebraska,NE,463585,452245,452245,0,11340,747,10593,2.446153348,MU,31,31055
Douglas County,Nevada,NV,41259,28444,7622,20822,12815,330,12485,31.05988996,MU,32,32005
Douglas County,Oregon,OR,100399,58341,0,58341,42058,3006,39052,41.89085549,MU,41,41019
Douglas County,South Dakota,SD,3458,0,0,0,3458,1098,2360,100,CR,46,46043
Douglas County,Washington,WA,32603,22678,22678,0,9925,1244,8681,30.44198387,MU,53,53017
Douglas County,Wisconsin,WI,43287,26519,26519,0,16768,369,16399,38.7368032,MU,55,55031
Drew County,Arkansas,AR,18723,8709,0,8709,10014,382,9632,53.48501843,MR,5,5043
Dubois County,Indiana,IN,39674,18724,0,18724,20950,1597,19353,52.80536371,MR,18,18037
Dubuque County,Iowa,IA,89143,66217,62340,3877,22926,3188,19738,25.71822802,MU,19,19061
Duchesne County,Utah,UT,14371,4016,0,4016,10355,974,9381,72.05483265,MR,49,49013
Dukes County,Massachusetts,MA,14987,5597,0,5597,9390,115,9275,62.65430039,MR,25,25007
Dundy County,Nebraska,NE,2292,0,0,0,2292,540,1752,100,CR,31,31057
Dunklin County,Missouri,MO,33155,16718,0,16718,16437,474,15963,49.57623285,MU,29,29069
Dunn County,North Dakota,ND,3600,0,0,0,3600,1040,2560,100,CR,38,38025
Dunn County,Wisconsin,WI,39858,16556,0,16556,23302,2896,20406,58.46254202,MR,55,55033
DuPage County,Illinois,IL,904161,903525,903525,0,636,0,636,0.070341455,MU,17,17043
Duplin County,North Carolina,NC,49063,6606,0,6606,42457,1455,41002,86.53567862,MR,37,37061
Durham County,North Carolina,NC,223314,206551,206551,0,16763,432,16331,7.506470709,MU,37,37063
Dutchess County,New York,NY,280150,198317,186917,11400,81833,1066,80767,29.21042299,MU,36,36027
Duval County,Florida,FL,778879,749233,749233,0,29646,315,29331,3.80623948,MU,12,12031
Duval County,Texas,TX,13120,6797,0,6797,6323,272,6051,48.19359756,MU,48,48131
Dyer County,Tennessee,TN,37279,20673,0,20673,16606,859,15747,44.5451863,MU,47,47045
Eagle County,Colorado,CO,41659,28631,0,28631,13028,274,12754,31.27295422,MU,8,8037
Early County,Georgia,GA,12354,4610,0,4610,7744,268,7476,62.68415088,MR,13,13099
East Baton Rouge Parish,Louisiana,LA,412852,383634,383634,0,29218,376,28842,7.077112379,MU,22,22033
East Carroll Parish,Louisiana,LA,9421,6048,0,6048,3373,203,3170,35.80299331,MU,22,22035
East Feliciana Parish,Louisiana,LA,21360,3533,0,3533,17827,624,17203,83.45973783,MR,22,22037
Eastland County,Texas,TX,18297,7494,0,7494,10803,913,9890,59.04246598,MR,48,48133
Eaton County,Michigan,MI,103655,62757,45617,17140,40898,2343,38555,39.45588732,MU,26,26045
Eau Claire County,Wisconsin,WI,93142,71972,71972,0,21170,2005,19165,22.72873677,MU,55,55035
Echols County,Georgia,GA,3754,0,0,0,3754,146,3608,100,CR,13,13101
Ector County,Texas,TX,121123,109969,109969,0,11154,550,10604,9.208820785,MU,48,48135
Eddy County,New Mexico,NM,51658,38980,0,38980,12678,675,12003,24.54218127,MU,35,35015
Eddy County,North Dakota,ND,2757,0,0,0,2757,555,2202,100,CR,38,38027
Edgar County,Illinois,IL,19704,9290,0,9290,10414,1424,8990,52.85221275,MR,17,17045
Edgecombe County,North Carolina,NC,55606,30539,18263,12276,25067,835,24232,45.07966766,MU,37,37065
Edgefield County,South Carolina,SC,24595,5218,954,4264,19377,543,18834,78.78430575,MR,45,45037
Edmonson County,Kentucky,KY,11644,0,0,0,11644,853,10791,100,CR,21,21061
Edmunds County,South Dakota,SD,4367,0,0,0,4367,756,3611,100,CR,46,46045
Edwards County,Illinois,IL,6971,0,0,0,6971,693,6278,100,CR,17,17047
Edwards County,Kansas,KS,3449,0,0,0,3449,314,3135,100,CR,20,20047
Edwards County,Texas,TX,2162,0,0,0,2162,277,1885,100,CR,48,48137
Effingham County,Georgia,GA,37535,8571,0,8571,28964,296,28668,77.16531238,MR,13,13103
Effingham County,Illinois,IL,34264,13959,0,13959,20305,1948,18357,59.26044828,MR,17,17049
El Dorado County,California,CA,156299,98536,17893,80643,57763,1097,56666,36.95673037,MU,6,6017
El Paso County,Colorado,CO,516929,467980,466133,1847,48949,1521,47428,9.469192094,MU,8,8041
El Paso County,Texas,TX,679622,659504,649429,10075,20118,703,19415,2.960174921,MU,48,48141
Elbert County,Colorado,CO,19872,0,0,0,19872,1615,18257,100,CR,8,8039
Elbert County,Georgia,GA,20511,6428,0,6428,14083,430,13653,68.66071864,MR,13,13105
Elk County,Kansas,KS,3261,0,0,0,3261,391,2870,100,CR,20,20049
Elk County,Pennsylvania,PA,35112,18332,0,18332,16780,177,16603,47.78992937,MU,42,42047
Elkhart County,Indiana,IN,182791,142915,133425,9490,39876,4541,35335,21.81507842,MU,18,18039
Elko County,Nevada,NV,45291,23916,0,23916,21375,555,20820,47.19480692,MU,32,32007
Elliott County,Kentucky,KY,6748,0,0,0,6748,924,5824,100,CR,21,21063
Ellis County,Kansas,KS,27507,20593,0,20593,6914,929,5985,25.13542007,MU,20,20051
Ellis County,Oklahoma,OK,4075,0,0,0,4075,552,3523,100,CR,40,40045
Ellis County,Texas,TX,111360,65642,21125,44517,45718,1691,44027,41.05423851,MU,48,48139
Ellsworth County,Kansas,KS,6525,2792,0,2792,3733,549,3184,57.21072797,MR,20,20053
Elmore County,Alabama,AL,65874,24734,0,24734,41140,680,40460,62.45256095,MR,1,1051
Elmore County,Idaho,ID,29130,22305,0,22305,6825,541,6284,23.42945417,MU,16,16039
Emanuel County,Georgia,GA,21837,6540,0,6540,15297,352,14945,70.05083116,MR,13,13107
Emery County,Utah,UT,10860,0,0,0,10860,503,10357,100,CR,49,49015
Emmet County,Iowa,IA,11027,6587,0,6587,4440,813,3627,40.26480457,MU,19,19063
Emmet County,Michigan,MI,31437,8264,0,8264,23173,339,22834,73.71250437,MR,26,26047
Emmons County,North Dakota,ND,4331,0,0,0,4331,1119,3212,100,CR,38,38029
Emporia city,Virginia,VA,5665,5226,0,5226,439,0,439,7.749338041,MU,51,51595
Erath County,Texas,TX,33001,18732,0,18732,14269,2126,12143,43.23808369,MU,48,48143
Erie County,New York,NY,950265,864891,851824,13067,85374,1373,84001,8.984230715,MU,36,36029
Erie County,Ohio,OH,79551,58506,57142,1364,21045,550,20495,26.45472716,MU,39,39043
Erie County,Pennsylvania,PA,280843,225835,194674,31161,55008,1696,53312,19.5867442,MU,42,42049
Escambia County,Alabama,AL,38440,15086,0,15086,23354,579,22775,60.75442248,MR,1,1053
Escambia County,Florida,FL,294410,262062,259045,3017,32348,687,31661,10.98739853,MU,12,12033
Esmeralda County,Nevada,NV,971,0,0,0,971,24,947,100,CR,32,32009
Essex County,Massachusetts,MA,723419,689252,689252,0,34167,323,33844,4.722989028,MU,25,25009
Essex County,New Jersey,NJ,793633,793310,793310,0,323,0,323,0.040698912,MU,34,34013
Essex County,New York,NY,38851,9805,0,9805,29046,283,28763,74.76255437,MR,36,36031
Essex County,Vermont,VT,6459,0,0,0,6459,118,6341,100,CR,50,50009
Essex County,Virginia,VA,9989,1944,0,1944,8045,210,7835,80.53859245,MR,51,51057
Estill County,Kentucky,KY,15307,4205,0,4205,11102,751,10351,72.52890834,MR,21,21065
Etowah County,Alabama,AL,103459,62225,61634,591,41234,897,40337,39.85540166,MU,1,1055
Eureka County,Nevada,NV,1651,0,0,0,1651,147,1504,100,CR,32,32011
Evangeline Parish,Louisiana,LA,35434,14215,0,14215,21219,809,20410,59.88316306,MR,22,22039
Evans County,Georgia,GA,10495,4037,0,4037,6458,231,6227,61.53406384,MR,13,13109
Fairbanks North Star Borough,Alaska,AK,82840,58284,52407,5877,24556,157,24399,29.64268469,MU,2,2090
Fairfax city,Virginia,VA,21498,21498,21498,0,0,0,0,0,MU,51,51600
Fairfax County,Virginia,VA,969749,956082,956082,0,13667,23,13644,1.409333755,MU,51,51059
Fairfield County,Connecticut,CT,882567,845940,845940,0,36627,250,36377,4.150053197,MU,9,9001
Fairfield County,Ohio,OH,122759,74867,32559,42308,47892,2069,45823,39.01302552,MU,39,39045
Fairfield County,South Carolina,SC,23454,5955,0,5955,17499,447,17052,74.60987465,MR,45,45039
Fall River County,South Dakota,SD,7453,4077,0,4077,3376,612,2764,45.29719576,MU,46,46047
Fallon County,Montana,MT,2837,0,0,0,2837,391,2446,100,CR,30,30025
Falls Church city,Virginia,VA,10377,10377,10377,0,0,0,0,0,MU,51,51610
Falls County,Texas,TX,18576,7914,0,7914,10662,978,9684,57.39664083,MR,48,48145
Fannin County,Georgia,GA,19798,0,0,0,19798,203,19595,100,CR,13,13111
Fannin County,Texas,TX,31242,9684,0,9684,21558,1458,20100,69.00326484,MR,48,48147
Faribault County,Minnesota,MN,16181,3478,0,3478,12703,1914,10789,78.50565478,MR,27,27043
Faulk County,South Dakota,SD,2640,0,0,0,2640,658,1982,100,CR,46,46049
Faulkner County,Arkansas,AR,86014,43960,0,43960,42054,1009,41045,48.89204083,MU,5,5045
Fauquier County,Virginia,VA,55139,15283,0,15283,39856,1733,38123,72.28277626,MR,51,51061
Fayette County,Alabama,AL,18495,3997,0,3997,14498,474,14024,78.38875372,MR,1,1057
Fayette County,Georgia,GA,91263,71313,71313,0,19950,297,19653,21.85989941,MU,13,13113
Fayette County,Illinois,IL,21802,7796,0,7796,14006,1699,12307,64.24181268,MR,17,17051
Fayette County,Indiana,IN,25588,16814,0,16814,8774,734,8040,34.28951071,MU,18,18041
Fayette County,Iowa,IA,22008,6456,0,6456,15552,3274,12278,70.66521265,MR,19,19065
Fayette County,Kentucky,KY,260512,249378,249241,137,11134,1148,9986,4.273891414,MU,21,21067
Fayette County,Ohio,OH,28433,14704,0,14704,13729,1076,12653,48.28544297,MU,39,39047
Fayette County,Pennsylvania,PA,148644,79059,66182,12877,69585,1115,68470,46.81319125,MU,42,42051
Fayette County,Tennessee,TN,28806,0,0,0,28806,922,27884,100,CR,47,47047
Fayette County,Texas,TX,21804,7868,0,7868,13936,2550,11386,63.914878,MR,48,48149
Fayette County,West Virginia,WV,47579,18717,2597,16120,28862,91,28771,60.66121608,MR,54,54019
Fentress County,Tennessee,TN,16625,0,0,0,16625,530,16095,100,CR,47,47049
Fergus County,Montana,MT,11893,6364,0,6364,5529,1510,4019,46.48953166,MU,30,30027
Ferry County,Washington,WA,7260,0,0,0,7260,270,6990,100,CR,53,53019
Fillmore County,Minnesota,MN,21122,0,0,0,21122,3968,17154,100,CR,27,27045
Fillmore County,Nebraska,NE,6634,0,0,0,6634,882,5752,100,CR,31,31059
Finney County,Kansas,KS,40523,32770,0,32770,7753,772,6981,19.13234459,MU,20,20055
Fisher County,Texas,TX,4344,0,0,0,4344,381,3963,100,CR,48,48151
Flagler County,Florida,FL,49832,33602,5320,28282,16230,166,16064,32.5694333,MU,12,12035
Flathead County,Montana,MT,74471,35294,0,35294,39177,1463,37714,52.6070551,MR,30,30029
Fleming County,Kentucky,KY,13792,2816,0,2816,10976,1597,9379,79.58236659,MR,21,21069
Florence County,South Carolina,SC,125761,72929,64201,8728,52832,1289,51543,42.00984407,MU,45,45041
Florence County,Wisconsin,WI,5088,0,0,0,5088,121,4967,100,CR,55,55037
Floyd County,Georgia,GA,90565,59041,59041,0,31524,536,30988,34.80814884,MU,13,13115
Floyd County,Indiana,IN,70823,56150,56150,0,14673,372,14301,20.7178459,MU,18,18043
Floyd County,Iowa,IA,16900,7460,0,7460,9440,1711,7729,55.85798817,MR,19,19067
Floyd County,Kentucky,KY,42441,5318,0,5318,37123,713,36410,87.46966377,MR,21,21071
Floyd County,Texas,TX,7771,3858,0,3858,3913,504,3409,50.35387981,MR,48,48153
Floyd County,Virginia,VA,13874,0,0,0,13874,575,13299,100,CR,51,51063
Fluvanna County,Virginia,VA,20047,5960,0,5960,14087,477,13610,70.26986582,MR,51,51065
Foard County,Texas,TX,1622,0,0,0,1622,164,1458,100,CR,48,48155
Fond du Lac County,Wisconsin,WI,97296,60225,49963,10262,37071,3063,34008,38.10125802,MU,55,55039
Ford County,Illinois,IL,14241,8128,0,8128,6113,841,5272,42.92535637,MU,17,17053
Ford County,Kansas,KS,32458,25973,0,25973,6485,651,5834,19.97966603,MU,20,20057
Forest County,Pennsylvania,PA,4946,0,0,0,4946,25,4921,100,CR,42,42053
Forest County,Wisconsin,WI,10024,0,0,0,10024,102,9922,100,CR,55,55041
Forrest County,Mississippi,MS,72604,48452,48452,0,24152,682,23470,33.26538483,MU,28,28035
Forsyth County,Georgia,GA,98407,64833,64833,0,33574,253,33321,34.11749164,MU,13,13117
Forsyth County,North Carolina,NC,306067,278251,278251,0,27816,519,27297,9.088206177,MU,37,37067
Fort Bend County,Texas,TX,354452,318799,316362,2437,35653,1207,34446,10.05862571,MU,48,48157
Foster County,North Dakota,ND,3759,0,0,0,3759,374,3385,100,CR,38,38031
Fountain County,Indiana,IN,17954,6193,0,6193,11761,896,10865,65.50629386,MR,18,18045
Franklin city,Virginia,VA,8346,8189,0,8189,157,25,132,1.881140666,MU,51,51620
Franklin County,Alabama,AL,31223,8566,0,8566,22657,942,21715,72.56509624,MR,1,1059
Franklin County,Arkansas,AR,17771,2833,0,2833,14938,1060,13878,84.05829723,MR,5,5047
Franklin County,Florida,FL,11057,2974,0,2974,8083,30,8053,73.10301167,MR,12,12037
Franklin County,Georgia,GA,20285,2193,0,2193,18092,1061,17031,89.18905595,MR,13,13119
Franklin County,Idaho,ID,11329,3437,0,3437,7892,753,7139,69.66192956,MR,16,16041
Franklin County,Illinois,IL,39018,20563,0,20563,18455,1001,17454,47.29868266,MU,17,17055
Franklin County,Indiana,IN,22151,4521,0,4521,17630,1239,16391,79.59008623,MR,18,18047
Franklin County,Iowa,IA,10704,3607,0,3607,7097,1543,5554,66.30231689,MR,19,19069
Franklin County,Kansas,KS,24784,11803,0,11803,12981,1417,11564,52.37653325,MR,20,20059
Franklin County,Kentucky,KY,47687,35077,0,35077,12610,879,11731,26.44326546,MU,21,21073
Franklin County,Maine,ME,29467,5104,0,5104,24363,524,23839,82.67892897,MR,23,23007
Franklin County,Massachusetts,MA,71535,32448,0,32448,39087,851,38236,54.64038583,MR,25,25011
Franklin County,Mississippi,MS,8448,0,0,0,8448,74,8374,100,CR,28,28037
Franklin County,Missouri,MO,93807,39387,0,39387,54420,2088,52332,58.01272826,MR,29,29071
Franklin County,Nebraska,NE,3574,0,0,0,3574,595,2979,100,CR,31,31061
Franklin County,New York,NY,51134,20048,0,20048,31086,960,30126,60.79321,MR,36,36033
Franklin County,North Carolina,NC,47260,4123,856,3267,43137,1112,42025,91.27592044,MR,37,37069
Franklin County,Ohio,OH,1068978,1049306,1046772,2534,19672,671,19001,1.840262381,MU,39,39049
Franklin County,Pennsylvania,PA,129313,68315,1389,66926,60998,3263,57735,47.17081809,MU,42,42055
Franklin County,Tennessee,TN,39270,11737,0,11737,27533,1114,26419,70.11204482,MR,47,47051
Franklin County,Texas,TX,9458,591,0,591,8867,616,8251,93.75132163,MR,48,48159
Franklin County,Vermont,VT,45417,13055,0,13055,32362,1821,30541,71.25525684,MR,50,50011
Franklin County,Virginia,VA,47286,4264,0,4264,43022,1127,41895,90.98253183,MR,51,51067
Franklin County,Washington,WA,49347,39581,36705,2876,9766,2013,7753,19.79046345,MU,53,53021
Franklin Parish,Louisiana,LA,21263,6473,0,6473,14790,1080,13710,69.55744721,MR,22,22041
Frederick County,Maryland,MD,195277,140182,119633,20549,55095,1847,53248,28.21376813,MU,24,24021
Frederick County,Virginia,VA,59209,30038,30038,0,29171,896,28275,49.26784779,MU,51,51069
Fredericksburg city,Virginia,VA,19279,19199,19199,0,80,0,80,0.414959282,MU,51,51630
Freeborn County,Minnesota,MN,32584,18226,0,18226,14358,2488,11870,44.06457157,MU,27,27047
Freestone County,Texas,TX,17867,7391,0,7391,10476,703,9773,58.63323445,MR,48,48161
Fremont County,Colorado,CO,46145,33872,0,33872,12273,635,11638,26.59659768,MU,8,8043
Fremont County,Idaho,ID,11819,3283,0,3283,8536,538,7998,72.22269228,MR,16,16043
Fremont County,Iowa,IA,8010,0,0,0,8010,1035,6975,100,CR,19,19071
Fremont County,Wyoming,WY,35804,17049,0,17049,18755,1678,17077,52.38241537,MR,56,56013
Fresno County,California,CA,799407,698377,554727,143650,101030,13834,87196,12.638118,MU,6,6019
Frio County,Texas,TX,16252,12277,0,12277,3975,309,3666,24.45852818,MU,48,48163
Frontier County,Nebraska,NE,3099,0,0,0,3099,668,2431,100,CR,31,31063
Fulton County,Arkansas,AR,11642,1091,0,1091,10551,933,9618,90.62875795,MR,5,5049
Fulton County,Georgia,GA,816006,799126,796299,2827,16880,277,16603,2.068612241,MU,13,13121
Fulton County,Illinois,IL,38250,17572,0,17572,20678,1861,18817,54.06013072,MR,17,17057
Fulton County,Indiana,IN,20511,7252,0,7252,13259,1722,11537,64.6433621,MR,18,18049
Fulton County,Kentucky,KY,7752,2805,0,2805,4947,335,4612,63.81578947,MR,21,21075
Fulton County,New York,NY,55073,27515,0,27515,27558,402,27156,50.03903909,MR,36,36035
Fulton County,Ohio,OH,42084,18079,0,18079,24005,2040,21965,57.04068054,MR,39,39051
Fulton County,Pennsylvania,PA,14261,0,0,0,14261,562,13699,100,CR,42,42057
Furnas County,Nebraska,NE,5324,0,0,0,5324,539,4785,100,CR,31,31065
Gadsden County,Florida,FL,45087,15252,0,15252,29835,732,29103,66.17206734,MR,12,12039
Gage County,Nebraska,NE,22993,12894,0,12894,10099,2018,8081,43.92206324,MU,31,31067
Gaines County,Texas,TX,14467,5997,0,5997,8470,443,8027,58.54703809,MR,48,48165
Galax city,Virginia,VA,6837,6204,0,6204,633,0,633,9.258446687,MU,51,51640
Gallatin County,Illinois,IL,6445,0,0,0,6445,430,6015,100,CR,17,17059
Gallatin County,Kentucky,KY,7870,0,0,0,7870,321,7549,100,CR,21,21077
Gallatin County,Montana,MT,67831,38460,0,38460,29371,1580,27791,43.30026094,MU,30,30031
Gallia County,Ohio,OH,31069,7101,0,7101,23968,1143,22825,77.14442048,MR,39,39053
Galveston County,Texas,TX,250158,229164,229164,0,20994,287,20707,8.392296069,MU,48,48167
Garden County,Nebraska,NE,2292,0,0,0,2292,289,2003,100,CR,31,31069
Garfield County,Colorado,CO,43791,30728,0,30728,13063,766,12297,29.83033043,MU,8,8045
Garfield County,Montana,MT,1279,0,0,0,1279,518,761,100,CR,30,30033
Garfield County,Nebraska,NE,1902,0,0,0,1902,323,1579,100,CR,31,31071
Garfield County,Oklahoma,OK,57813,45643,0,45643,12170,1489,10681,21.05062875,MU,40,40047
Garfield County,Utah,UT,4735,0,0,0,4735,104,4631,100,CR,49,49017
Garfield County,Washington,WA,2397,0,0,0,2397,242,2155,100,CR,53,53023
Garland County,Arkansas,AR,88068,55757,51269,4488,32311,424,31887,36.6886951,MU,5,5051
Garrard County,Kentucky,KY,14792,3953,0,3953,10839,1338,9501,73.27609519,MR,21,21079
Garrett County,Maryland,MD,29846,4998,0,4998,24848,1093,23755,83.25403739,MR,24,24023
Garvin County,Oklahoma,OK,27210,8635,0,8635,18575,1309,17266,68.26534362,MR,40,40049
Garza County,Texas,TX,4872,3133,0,3133,1739,289,1450,35.69376026,MU,48,48169
Gasconade County,Missouri,MO,15342,5178,0,5178,10164,811,9353,66.24951115,MR,29,29073
Gaston County,North Carolina,NC,190365,147591,140931,6660,42774,517,42257,22.46946655,MU,37,37071
Gates County,North Carolina,NC,10516,0,0,0,10516,538,9978,100,CR,37,37073
Geary County,Kansas,KS,27947,24020,0,24020,3927,485,3442,14.05159767,MU,20,20061
Geauga County,Ohio,OH,90895,33528,19732,13796,57367,1990,55377,63.11348259,MR,39,39055
Gem County,Idaho,ID,15181,8198,0,8198,6983,895,6088,45.99828733,MU,16,16045
Genesee County,Michigan,MI,436141,365630,362423,3207,70511,1111,69400,16.16701938,MU,26,26049
Genesee County,New York,NY,60370,24441,0,24441,35929,889,35040,59.5146596,MR,36,36037
Geneva County,Alabama,AL,25764,3392,172,3220,22372,1232,21140,86.83434249,MR,1,1061
Gentry County,Missouri,MO,6861,0,0,0,6861,828,6033,100,CR,29,29075
George County,Mississippi,MS,19144,0,0,0,19144,479,18665,100,CR,28,28039
Georgetown County,South Carolina,SC,55797,30514,5246,25268,25283,707,24576,45.312472,MU,45,45043
Gibson County,Indiana,IN,32500,15083,0,15083,17417,1174,16243,53.59076923,MR,18,18051
Gibson County,Tennessee,TN,48152,24267,0,24267,23885,1621,22264,49.60333943,MU,47,47053
Gila County,Arizona,AZ,51335,28741,0,28741,22594,222,22372,44.01285673,MU,4,4007
Gilchrist County,Florida,FL,14437,0,0,0,14437,681,13756,100,CR,12,12041
Giles County,Tennessee,TN,29447,7632,0,7632,21815,2118,19697,74.08224947,MR,47,47055
Giles County,Virginia,VA,16657,2830,0,2830,13827,305,13522,83.01014588,MR,51,51071
Gillespie County,Texas,TX,20814,9556,0,9556,11258,1874,9384,54.08859422,MR,48,48171
Gilliam County,Oregon,OR,1915,0,0,0,1915,251,1664,100,CR,41,41021
Gilmer County,Georgia,GA,23456,3418,0,3418,20038,443,19595,85.42803547,MR,13,13123
Gilmer County,West Virginia,WV,7160,0,0,0,7160,370,6790,100,CR,54,54021
Gilpin County,Colorado,CO,4757,0,0,0,4757,30,4727,100,CR,8,8047
Glacier County,Montana,MT,13247,7681,0,7681,5566,777,4789,42.01706047,MU,30,30035
Glades County,Florida,FL,10576,2790,0,2790,7786,150,7636,73.61951589,MR,12,12043
Gladwin County,Michigan,MI,26023,2718,0,2718,23305,790,22515,89.55539331,MR,26,26051
Glascock County,Georgia,GA,2556,0,0,0,2556,7,2549,100,CR,13,13125
Glasscock County,Texas,TX,1406,0,0,0,1406,307,1099,100,CR,48,48173
Glenn County,California,CA,26453,14971,0,14971,11482,2242,9240,43.40528484,MU,6,6021
Gloucester County,New Jersey,NJ,254673,226397,226397,0,28276,710,27566,11.10286524,MU,34,34015
Gloucester County,Virginia,VA,34780,9731,9731,0,25049,392,24657,72.0212766,MR,51,51073
Glynn County,Georgia,GA,67568,51846,51846,0,15722,66,15656,23.26841108,MU,13,13127
Gogebic County,Michigan,MI,17370,6215,0,6215,11155,86,11069,64.2199194,MR,26,26053
Golden Valley County,Montana,MT,1042,0,0,0,1042,198,844,100,CR,30,30037
Golden Valley County,North Dakota,ND,1924,0,0,0,1924,246,1678,100,CR,38,38033
Goliad County,Texas,TX,6928,0,0,0,6928,530,6398,100,CR,48,48175
Gonzales County,Texas,TX,18628,6868,0,6868,11760,1869,9891,63.13077088,MR,48,48177
Goochland County,Virginia,VA,16863,892,443,449,15971,413,15558,94.71031252,MR,51,51075
Goodhue County,Minnesota,MN,44127,21633,0,21633,22494,3625,18869,50.97559317,MR,27,27049
Gooding County,Idaho,ID,14155,3598,0,3598,10557,1367,9190,74.58141999,MR,16,16047
Gordon County,Georgia,GA,44104,15072,0,15072,29032,822,28210,65.82622891,MR,13,13129
Goshen County,Wyoming,WY,12538,6953,0,6953,5585,1358,4227,44.54458446,MU,56,56015
Gosper County,Nebraska,NE,2143,0,0,0,2143,473,1670,100,CR,31,31073
Gove County,Kansas,KS,3068,0,0,0,3068,553,2515,100,CR,20,20063
Grady County,Georgia,GA,23659,9007,0,9007,14652,908,13744,61.92992096,MR,13,13131
Grady County,Oklahoma,OK,45516,15508,0,15508,30008,1802,28206,65.92846472,MR,40,40051
Grafton County,New Hampshire,NH,81743,28746,0,28746,52997,673,52324,64.83368606,MR,33,33009
Graham County,Arizona,AZ,33489,14829,0,14829,18660,171,18489,55.71978859,MR,4,4009
Graham County,Kansas,KS,2946,0,0,0,2946,347,2599,100,CR,20,20065
Graham County,North Carolina,NC,7993,0,0,0,7993,185,7808,100,CR,37,37075
Grainger County,Tennessee,TN,20659,0,0,0,20659,1764,18895,100,CR,47,47057
Grand County,Colorado,CO,12442,0,0,0,12442,354,12088,100,CR,8,8049
Grand County,Utah,UT,8485,6537,0,6537,1948,47,1901,22.95816146,MU,49,49019
Grand Forks County,North Dakota,ND,66109,54500,49168,5332,11609,994,10615,17.56039268,MU,38,38035
Grand Isle County,Vermont,VT,6901,0,0,0,6901,200,6701,100,CR,50,50013
Grand Traverse County,Michigan,MI,77654,38357,0,38357,39297,946,38351,50.60524892,MR,26,26055
Granite County,Montana,MT,2830,0,0,0,2830,344,2486,100,CR,30,30039
Grant County,Arkansas,AR,16464,3719,0,3719,12745,159,12586,77.41132167,MR,5,5053
Grant County,Indiana,IN,73403,52278,0,52278,21125,1177,19948,28.77947768,MU,18,18053
Grant County,Kansas,KS,7909,6280,0,6280,1629,330,1299,20.59678847,MU,20,20067
Grant County,Kentucky,KY,22384,4962,0,4962,17422,1474,15948,77.83238027,MR,21,21081
Grant County,Minnesota,MN,6289,0,0,0,6289,868,5421,100,CR,27,27051
Grant County,Nebraska,NE,747,0,0,0,747,131,616,100,CR,31,31075
Grant County,New Mexico,NM,31002,17861,0,17861,13141,330,12811,42.3875879,MU,35,35017
Grant County,North Dakota,ND,2841,0,0,0,2841,866,1975,100,CR,38,38037
Grant County,Oklahoma,OK,5144,0,0,0,5144,771,4373,100,CR,40,40053
Grant County,Oregon,OR,7935,0,0,0,7935,715,7220,100,CR,41,41023
Grant County,South Dakota,SD,7847,3530,0,3530,4317,1049,3268,55.01465528,MR,46,46051
Grant County,Washington,WA,74698,39422,0,39422,35276,2833,32443,47.2248253,MU,53,53025
Grant County,West Virginia,WV,11299,2537,0,2537,8762,590,8172,77.54668555,MR,54,54023
Grant County,Wisconsin,WI,49597,17117,0,17117,32480,5256,27224,65.48783193,MR,55,55043
Grant Parish,Louisiana,LA,18698,0,0,0,18698,326,18372,100,CR,22,22043
Granville County,North Carolina,NC,48498,16696,0,16696,31802,1005,30797,65.5738381,MR,37,37077
Gratiot County,Michigan,MI,42285,19284,0,19284,23001,2804,20197,54.39517559,MR,26,26057
Graves County,Kentucky,KY,37028,11199,0,11199,25829,2561,23268,69.7553203,MR,21,21083
Gray County,Kansas,KS,5904,0,0,0,5904,439,5465,100,CR,20,20069
Gray County,Texas,TX,22744,17986,0,17986,4758,222,4536,20.91980302,MU,48,48179
Grays Harbor County,Washington,WA,67194,40722,0,40722,26472,606,25866,39.39637468,MU,53,53027
Grayson County,Kentucky,KY,24053,5419,0,5419,18634,2212,16422,77.47058579,MR,21,21085
Grayson County,Texas,TX,110595,59356,55814,3542,51239,1998,49241,46.33030426,MU,48,48181
Grayson County,Virginia,VA,17917,104,0,104,17813,973,16840,99.41954568,MR,51,51077
Greeley County,Kansas,KS,1534,0,0,0,1534,126,1408,100,CR,20,20071
Greeley County,Nebraska,NE,2714,0,0,0,2714,592,2122,100,CR,31,31077
Green County,Kentucky,KY,11518,0,0,0,11518,1649,9869,100,CR,21,21087
Green County,Wisconsin,WI,33647,14412,0,14412,19235,3034,16201,57.16705798,MR,55,55045
Green Lake County,Wisconsin,WI,19105,4711,0,4711,14394,1335,13059,75.34153363,MR,55,55047
Greenbrier County,West Virginia,WV,34453,9954,0,9954,24499,1045,23454,71.10846661,MR,54,54025
Greene County,Alabama,AL,9974,0,0,0,9974,536,9438,100,CR,1,1063
Greene County,Arkansas,AR,37331,19079,0,19079,18252,807,17445,48.89234149,MU,5,5055
Greene County,Georgia,GA,14406,2631,0,2631,11775,403,11372,81.73677634,MR,13,13133
Greene County,Illinois,IL,14761,4643,0,4643,10118,1244,8874,68.5454915,MR,17,17061
Greene County,Indiana,IN,33157,11637,0,11637,21520,1325,20195,64.90333866,MR,18,18055
Greene County,Iowa,IA,10366,4445,0,4445,5921,1124,4797,57.1194289,MR,19,19073
Greene County,Mississippi,MS,13299,0,0,0,13299,374,12925,100,CR,28,28041
Greene County,Missouri,MO,240391,196854,188146,8708,43537,2218,41319,18.11091097,MU,29,29077
Greene County,New York,NY,48195,14490,0,14490,33705,445,33260,69.93464052,MR,36,36039
Greene County,North Carolina,NC,18974,0,0,0,18974,613,18361,100,CR,37,37079
Greene County,Ohio,OH,147886,123477,111761,11716,24409,1957,22452,16.50528109,MU,39,39057
Greene County,Pennsylvania,PA,40672,12712,0,12712,27960,645,27315,68.74508261,MR,42,42059
Greene County,Tennessee,TN,62909,19443,0,19443,43466,3800,39666,69.09345245,MR,47,47059
Greene County,Virginia,VA,15244,0,0,0,15244,262,14982,100,CR,51,51079
Greenlee County,Arizona,AZ,8547,4324,0,4324,4223,179,4044,49.40914941,MU,4,4011
Greensville County,Virginia,VA,11560,3953,0,3953,7607,306,7301,65.80449827,MR,51,51081
Greenup County,Kentucky,KY,36891,22630,19537,3093,14261,602,13659,38.65712504,MU,21,21089
Greenville County,South Carolina,SC,379616,315095,314919,176,64521,872,63649,16.99638582,MU,45,45045
Greenwood County,Kansas,KS,7673,2873,0,2873,4800,690,4110,62.55701812,MR,20,20073
Greenwood County,South Carolina,SC,66271,37623,0,37623,28648,669,27979,43.22856151,MU,45,45047
Greer County,Oklahoma,OK,6061,2760,0,2760,3301,301,3000,54.46295991,MR,40,40055
Gregg County,Texas,TX,111379,89115,76050,13065,22264,193,22071,19.98940554,MU,48,48183
Gregory County,South Dakota,SD,4792,0,0,0,4792,917,3875,100,CR,46,46053
Grenada County,Mississippi,MS,23263,12956,0,12956,10307,418,9889,44.30640932,MU,28,28043
Griggs County,North Dakota,ND,2754,0,0,0,2754,540,2214,100,CR,38,38039
Grimes County,Texas,TX,23552,7700,0,7700,15852,1840,14012,67.30638587,MR,48,48185
Grundy County,Illinois,IL,37535,23030,2520,20510,14505,855,13650,38.64393233,MU,17,17063
Grundy County,Iowa,IA,12369,0,0,0,12369,1456,10913,100,CR,19,19075
Grundy County,Missouri,MO,10432,6129,0,6129,4303,888,3415,41.24808282,MU,29,29079
Grundy County,Tennessee,TN,14332,0,0,0,14332,539,13793,100,CR,47,47061
Guadalupe County,New Mexico,NM,4680,2530,0,2530,2150,269,1881,45.94017094,MU,35,35019
Guadalupe County,Texas,TX,89023,51825,20497,31328,37198,2061,35137,41.78470732,MU,48,48187
Guernsey County,Ohio,OH,40792,16564,0,16564,24228,1105,23123,59.39399882,MR,39,39059
Guilford County,North Carolina,NC,421048,352859,352859,0,68189,1346,66843,16.19506565,MU,37,37081
Gulf County,Florida,FL,13332,4415,0,4415,8917,36,8881,66.88418842,MR,12,12045
Gunnison County,Colorado,CO,13956,6382,0,6382,7574,255,7319,54.27056463,MR,8,8051
Guthrie County,Iowa,IA,11353,0,0,0,11353,1164,10189,100,CR,19,19077
Gwinnett County,Georgia,GA,588448,573448,573448,0,15000,34,14966,2.549078253,MU,13,13135
Haakon County,South Dakota,SD,2196,0,0,0,2196,517,1679,100,CR,46,46055
Habersham County,Georgia,GA,35902,12615,0,12615,23287,432,22855,64.86268174,MR,13,13137
Haines Borough,Alaska,AK,2392,0,0,0,2392,30,2362,100,CR,2,2100
Hale County,Alabama,AL,17185,2605,0,2605,14580,549,14031,84.84143148,MR,1,1065
Hale County,Texas,TX,36602,27817,0,27817,8785,823,7962,24.00142069,MU,48,48189
Halifax County,North Carolina,NC,57370,24468,0,24468,32902,846,32056,57.35053164,MR,37,37083
Halifax County,Virginia,VA,37355,8859,0,8859,28496,1439,27057,76.28429929,MR,51,51083
Hall County,Georgia,GA,139277,93269,93269,0,46008,1215,44793,33.03345132,MU,13,13139
Hall County,Nebraska,NE,53534,45064,0,45064,8470,1248,7222,15.82172078,MU,31,31079
Hall County,Texas,TX,3782,0,0,0,3782,122,3660,100,CR,48,48191
Hamblen County,Tennessee,TN,58128,43131,43131,0,14997,704,14293,25.79995871,MU,47,47063
Hamilton County,Florida,FL,13327,2485,0,2485,10842,200,10642,81.35364298,MR,12,12047
Hamilton County,Illinois,IL,8621,2866,0,2866,5755,604,5151,66.7555968,MR,17,17065
Hamilton County,Indiana,IN,182740,161477,158935,2542,21263,953,20310,11.63565722,MU,18,18057
Hamilton County,Iowa,IA,16438,7888,0,7888,8550,1463,7087,52.01362696,MR,19,19079
Hamilton County,Kansas,KS,2670,0,0,0,2670,192,2478,100,CR,20,20075
Hamilton County,Nebraska,NE,9403,4233,0,4233,5170,1050,4120,54.98245241,MR,31,31081
Hamilton County,New York,NY,5379,0,0,0,5379,9,5370,100,CR,36,36041
Hamilton County,Ohio,OH,845303,824562,824562,0,20741,144,20597,2.453676374,MU,39,39061
Hamilton County,Tennessee,TN,307896,277882,277882,0,30014,751,29263,9.74809676,MU,47,47065
Hamilton County,Texas,TX,8229,2910,0,2910,5319,963,4356,64.63725848,MR,48,48193
Hamlin County,South Dakota,SD,5540,0,0,0,5540,875,4665,100,CR,46,46057
Hampden County,Massachusetts,MA,456228,411873,411801,72,44355,421,43934,9.722112628,MU,25,25013
Hampshire County,Massachusetts,MA,152251,110408,65932,44476,41843,698,41145,27.48290652,MU,25,25015
Hampshire County,West Virginia,WV,20203,0,0,0,20203,741,19462,100,CR,54,54027
Hampton city,Virginia,VA,146437,146151,146151,0,286,0,286,0.195305831,MU,51,51650
Hampton County,South Carolina,SC,21386,7648,0,7648,13738,349,13389,64.23828673,MR,45,45049
Hancock County,Georgia,GA,10076,3970,0,3970,6106,354,5752,60.59944422,MR,13,13141
Hancock County,Illinois,IL,20121,5806,0,5806,14315,1705,12610,71.14457532,MR,17,17067
Hancock County,Indiana,IN,55391,34682,18349,16333,20709,1157,19552,37.38694012,MU,18,18059
Hancock County,Iowa,IA,12100,3114,0,3114,8986,1670,7316,74.26446281,MR,19,19081
Hancock County,Kentucky,KY,8392,919,0,919,7473,632,6841,89.04909438,MR,21,21091
Hancock County,Maine,ME,51791,2472,0,2472,49319,464,48855,95.22696994,MR,23,23009
Hancock County,Mississippi,MS,42967,26411,22135,4276,16556,303,16253,38.53189657,MU,28,28045
Hancock County,Ohio,OH,71295,48459,0,48459,22836,2487,20349,32.03029665,MU,39,39063
Hancock County,Tennessee,TN,6786,0,0,0,6786,740,6046,100,CR,47,47067
Hancock County,West Virginia,WV,32667,21678,16934,4744,10989,53,10936,33.63945266,MU,54,54029
Hand County,South Dakota,SD,3741,0,0,0,3741,779,2962,100,CR,46,46059
Hanover County,Virginia,VA,86320,48840,48840,0,37480,1037,36443,43.41983318,MU,51,51085
Hansford County,Texas,TX,5369,3043,0,3043,2326,211,2115,43.32277892,MU,48,48195
Hanson County,South Dakota,SD,3139,0,0,0,3139,673,2466,100,CR,46,46061
Haralson County,Georgia,GA,25690,4370,0,4370,21320,309,21011,82.98949007,MR,13,13143
Hardee County,Florida,FL,26938,14158,0,14158,12780,1111,11669,47.44227485,MU,12,12049
Hardeman County,Tennessee,TN,28105,10305,0,10305,17800,706,17094,63.33392635,MR,47,47069
Hardeman County,Texas,TX,4724,2796,0,2796,1928,178,1750,40.81287045,MU,48,48197
Hardin County,Illinois,IL,4800,0,0,0,4800,334,4466,100,CR,17,17069
Hardin County,Iowa,IA,18812,4829,0,4829,13983,1459,12524,74.33021476,MR,19,19083
Hardin County,Kentucky,KY,94174,60007,60007,0,34167,2992,31175,36.28071442,MU,21,21093
Hardin County,Ohio,OH,31945,14564,0,14564,17381,1991,15390,54.40914071,MR,39,39065
Hardin County,Tennessee,TN,25578,8002,0,8002,17576,599,16977,68.71530221,MR,47,47071
Hardin County,Texas,TX,48073,20501,11643,8858,27572,339,27233,57.35444012,MR,48,48199
Harding County,New Mexico,NM,810,0,0,0,810,138,672,100,CR,35,35021
Harding County,South Dakota,SD,1353,0,0,0,1353,541,812,100,CR,46,46063
Hardy County,West Virginia,WV,12669,0,0,0,12669,586,12083,100,CR,54,54031
Harford County,Maryland,MD,218590,170016,170016,0,48574,1084,47490,22.22151059,MU,24,24025
Harlan County,Kentucky,KY,33202,15829,0,15829,17373,132,17241,52.32516113,MR,21,21095
Harlan County,Nebraska,NE,3786,0,0,0,3786,424,3362,100,CR,31,31083
Harmon County,Oklahoma,OK,3283,0,0,0,3283,262,3021,100,CR,40,40057
Harnett County,North Carolina,NC,91025,30810,5183,25627,60215,1544,58671,66.152156,MR,37,37085
Harney County,Oregon,OR,7609,4221,0,4221,3388,958,2430,44.52621895,MU,41,41025
Harper County,Kansas,KS,6536,0,0,0,6536,639,5897,100,CR,20,20077
Harper County,Oklahoma,OK,3562,0,0,0,3562,371,3191,100,CR,40,40059
Harris County,Georgia,GA,23695,685,0,685,23010,344,22666,97.10909475,MR,13,13145
Harris County,Texas,TX,3400578,3338908,3323870,15038,61670,884,60786,1.813515232,MU,48,48201
Harrison County,Indiana,IN,34325,4367,123,4244,29958,1986,27972,87.27749454,MR,18,18061
Harrison County,Iowa,IA,15666,3163,0,3163,12503,1612,10891,79.80977914,MR,19,19085
Harrison County,Kentucky,KY,17983,6494,0,6494,11489,1860,9629,63.88811655,MR,21,21097
Harrison County,Mississippi,MS,189601,148595,148595,0,41006,594,40412,21.62752306,MU,28,28047
Harrison County,Missouri,MO,8850,2612,0,2612,6238,1325,4913,70.48587571,MR,29,29081
Harrison County,Ohio,OH,15856,2794,0,2794,13062,530,12532,82.37891019,MR,39,39067
Harrison County,Texas,TX,62110,25272,1625,23647,36838,1133,35705,59.31090002,MR,48,48203
Harrison County,West Virginia,WV,68652,39022,0,39022,29630,634,28996,43.15970401,MU,54,54033
Harrisonburg city,Virginia,VA,40468,40407,40407,0,61,20,41,0.150736384,MU,51,51660
Hart County,Georgia,GA,22997,5594,0,5594,17403,1039,16364,75.67508805,MR,13,13147
Hart County,Kentucky,KY,17445,2230,0,2230,15215,3017,12198,87.21696761,MR,21,21099
Hartford County,Connecticut,CT,857183,810317,810317,0,46866,535,46331,5.467443941,MU,9,9003
Hartley County,Texas,TX,5537,2375,0,2375,3162,242,2920,57.1067365,MR,48,48205
Harvey County,Kansas,KS,32869,22599,0,22599,10270,1461,8809,31.24524628,MU,20,20079
Haskell County,Kansas,KS,4307,0,0,0,4307,276,4031,100,CR,20,20081
Haskell County,Oklahoma,OK,11792,2540,0,2540,9252,910,8342,78.45997286,MR,40,40061
Haskell County,Texas,TX,6093,2880,0,2880,3213,375,2838,52.73264402,MR,48,48207
Hawaii County,Hawaii,HI,148677,86965,0,86965,61712,3826,57886,41.50742886,MU,15,15001
Hawkins County,Tennessee,TN,53563,20671,15456,5215,32892,2093,30799,61.40806154,MR,47,47073
Hayes County,Nebraska,NE,1068,0,0,0,1068,438,630,100,CR,31,31085
Hays County,Texas,TX,97589,56376,6371,50005,41213,970,40243,42.23119409,MU,48,48209
Haywood County,North Carolina,NC,54033,28162,28162,0,25871,843,25028,47.87999926,MU,37,37087
Haywood County,Tennessee,TN,19797,10309,0,10309,9488,834,8654,47.9264535,MU,47,47075
Heard County,Georgia,GA,11012,0,0,0,11012,278,10734,100,CR,13,13149
Hemphill County,Texas,TX,3351,0,0,0,3351,303,3048,100,CR,48,48211
Hempstead County,Arkansas,AR,23587,10403,0,10403,13184,874,12310,55.89519651,MR,5,5057
Henderson County,Illinois,IL,8213,121,0,121,8092,639,7453,98.52672592,MR,17,17071
Henderson County,Kentucky,KY,44829,26521,26521,0,18308,1011,17297,40.83963506,MU,21,21101
Henderson County,North Carolina,NC,89173,47057,47057,0,42116,510,41606,47.22954257,MU,37,37089
Henderson County,Tennessee,TN,25522,5799,0,5799,19723,862,18861,77.27842646,MR,47,47077
Henderson County,Texas,TX,73277,33244,0,33244,40033,1475,38558,54.63242218,MR,48,48213
Hendricks County,Indiana,IN,104093,73236,73236,0,30857,1304,29553,29.64368401,MU,18,18063
Hendry County,Florida,FL,36210,23076,0,23076,13134,222,12912,36.27174814,MU,12,12051
Hennepin County,Minnesota,MN,1116200,1090288,1086301,3987,25912,1023,24889,2.321447769,MU,27,27053
Henrico County,Virginia,VA,262300,247532,247532,0,14768,162,14606,5.630194434,MU,51,51087
Henry County,Alabama,AL,16310,0,0,0,16310,398,15912,100,CR,1,1067
Henry County,Georgia,GA,119341,86020,82893,3127,33321,536,32785,27.9208319,MU,13,13151
Henry County,Illinois,IL,51020,28377,6369,22008,22643,2610,20033,44.38063505,MU,17,17073
Henry County,Indiana,IN,48508,26917,0,26917,21591,1892,19699,44.51018389,MU,18,18065
Henry County,Iowa,IA,20336,8301,0,8301,12035,1205,10830,59.18076318,MR,19,19087
Henry County,Kentucky,KY,15060,0,0,0,15060,1632,13428,100,CR,21,21103
Henry County,Missouri,MO,21997,11779,0,11779,10218,1344,8874,46.45178888,MU,29,29083
Henry County,Ohio,OH,29210,9287,0,9287,19923,1980,17943,68.2060938,MR,39,39069
Henry County,Tennessee,TN,31115,10209,0,10209,20906,1275,19631,67.18945846,MR,47,47079
Henry County,Virginia,VA,57930,20540,0,20540,37390,381,37009,64.54341447,MR,51,51089
Herkimer County,New York,NY,64427,31199,1164,30035,33228,1394,31834,51.57465038,MR,36,36043
Hernando County,Florida,FL,130802,99574,96758,2816,31228,728,30500,23.87425269,MU,12,12053
Hertford County,North Carolina,NC,22601,7695,0,7695,14906,307,14599,65.95283395,MR,37,37091
Hettinger County,North Dakota,ND,2715,0,0,0,2715,560,2155,100,CR,38,38041
Hickman County,Kentucky,KY,5262,0,0,0,5262,520,4742,100,CR,21,21105
Hickman County,Tennessee,TN,22295,0,0,0,22295,933,21362,100,CR,47,47081
Hickory County,Missouri,MO,8940,0,0,0,8940,735,8205,100,CR,29,29085
Hidalgo County,New Mexico,NM,5932,2986,0,2986,2946,196,2750,49.66284558,MU,35,35023
Hidalgo County,Texas,TX,569463,531951,523042,8909,37512,803,36709,6.587258523,MU,48,48215
Highland County,Ohio,OH,40875,11606,0,11606,29269,2559,26710,71.60611621,MR,39,39071
Highland County,Virginia,VA,2536,0,0,0,2536,315,2221,100,CR,51,51091
Highlands County,Florida,FL,87366,58221,0,58221,29145,344,28801,33.35965936,MU,12,12055
Hill County,Montana,MT,16673,10338,0,10338,6335,736,5599,37.99556169,MU,30,30041
Hill County,Texas,TX,32321,8066,0,8066,24255,1471,22784,75.04408898,MR,48,48217
Hillsborough County,Florida,FL,998948,943085,912506,30579,55863,1707,54156,5.592182976,MU,12,12057
Hillsborough County,New Hampshire,NH,380841,297060,290565,6495,83781,550,83231,21.99894444,MU,33,33011
Hillsdale County,Michigan,MI,46527,11238,0,11238,35289,2394,32895,75.8462828,MR,26,26059
Hinds County,Mississippi,MS,250800,212708,212708,0,38092,1170,36922,15.18819777,MU,28,28049
Hinsdale County,Colorado,CO,790,0,0,0,790,32,758,100,CR,8,8053
Hitchcock County,Nebraska,NE,3111,0,0,0,3111,540,2571,100,CR,31,31087
Hocking County,Ohio,OH,28241,8749,0,8749,19492,405,19087,69.02021883,MR,39,39073
Hockley County,Texas,TX,22716,13487,0,13487,9229,492,8737,40.62775136,MU,48,48219
Hodgeman County,Kansas,KS,2085,0,0,0,2085,496,1589,100,CR,20,20083
Hoke County,North Carolina,NC,33646,14640,6632,8008,19006,682,18324,56.48814124,MR,37,37093
Holmes County,Florida,FL,18564,3919,0,3919,14645,616,14029,78.88924801,MR,12,12059
Holmes County,Mississippi,MS,21609,5836,0,5836,15773,670,15103,72.99273451,MR,28,28051
Holmes County,Ohio,OH,38943,3135,0,3135,35808,5446,30362,91.94977274,MR,39,39075
Holt County,Missouri,MO,5351,0,0,0,5351,697,4654,100,CR,29,29087
Holt County,Nebraska,NE,11551,3542,0,3542,8009,1888,6121,69.33598823,MR,31,31089
Honolulu County,Hawaii,HI,876156,862498,836318,26180,13658,406,13252,1.558854816,MU,15,15003
Hood County,Texas,TX,41100,25531,0,25531,15569,766,14803,37.88077859,MU,48,48221
Hood River County,Oregon,OR,20411,8704,0,8704,11707,1343,10364,57.35632747,MR,41,41027
Hooker County,Nebraska,NE,783,0,0,0,783,112,671,100,CR,31,31091
Hopewell city,Virginia,VA,22354,22354,22354,0,0,0,0,0,MU,51,51670
Hopkins County,Kentucky,KY,46519,25205,0,25205,21314,773,20541,45.81783787,MU,21,21107
Hopkins County,Texas,TX,31960,13061,0,13061,18899,1947,16952,59.13329161,MR,48,48223
Horry County,South Carolina,SC,196629,118817,118117,700,77812,2157,75655,39.57300296,MU,45,45051
Hot Spring County,Arkansas,AR,30353,9128,0,9128,21225,317,20908,69.92719006,MR,5,5059
Hot Springs County,Wyoming,WY,4882,3488,0,3488,1394,398,996,28.55387136,MU,56,56017
Houghton County,Michigan,MI,36016,20097,0,20097,15919,225,15694,44.19980009,MU,26,26061
Houston County,Alabama,AL,88787,57814,57814,0,30973,664,30309,34.88461149,MU,1,1069
Houston County,Georgia,GA,110765,94029,85657,8372,16736,192,16544,15.10946599,MU,13,13153
Houston County,Minnesota,MN,19718,8625,5769,2856,11093,2204,8889,56.2582412,MR,27,27055
Houston County,Tennessee,TN,8088,0,0,0,8088,321,7767,100,CR,47,47083
Houston County,Texas,TX,23185,6671,0,6671,16514,1202,15312,71.22708648,MR,48,48225
Howard County,Arkansas,AR,14300,4829,0,4829,9471,934,8537,66.23076923,MR,5,5061
Howard County,Indiana,IN,84964,66365,63318,3047,18599,1213,17386,21.89044772,MU,18,18067
Howard County,Iowa,IA,9932,3695,0,3695,6237,1761,4476,62.79701973,MR,19,19089
Howard County,Maryland,MD,247842,216617,215480,1137,31225,509,30716,12.59875243,MU,24,24027
Howard County,Missouri,MO,10212,3872,0,3872,6340,1158,5182,62.08382295,MR,29,29089
Howard County,Nebraska,NE,6567,0,0,0,6567,1219,5348,100,CR,31,31093
Howard County,Texas,TX,33627,26347,0,26347,7280,334,6946,21.64926993,MU,48,48227
Howell County,Missouri,MO,37238,10027,0,10027,27211,2227,24984,73.07320479,MR,29,29091
Hubbard County,Minnesota,MN,18376,3210,0,3210,15166,592,14574,82.53156291,MR,27,27057
Hudson County,New Jersey,NJ,608975,608975,608975,0,0,0,0,0,MU,34,34017
Hudspeth County,Texas,TX,3344,0,0,0,3344,93,3251,100,CR,48,48229
Huerfano County,Colorado,CO,7862,4058,0,4058,3804,192,3612,48.38463495,MU,8,8055
Hughes County,Oklahoma,OK,14154,5779,0,5779,8375,769,7606,59.17055249,MR,40,40063
Hughes County,South Dakota,SD,16481,12447,0,12447,4034,281,3753,24.4766701,MU,46,46065
Humboldt County,California,CA,126518,87936,0,87936,38582,1270,37312,30.4952655,MU,6,6023
Humboldt County,Iowa,IA,10381,5059,0,5059,5322,1010,4312,51.26673731,MR,19,19091
Humboldt County,Nevada,NV,16106,9416,0,9416,6690,297,6393,41.53731529,MU,32,32013
Humphreys County,Mississippi,MS,11206,6057,0,6057,5149,209,4940,45.94859896,MU,28,28053
Humphreys County,Tennessee,TN,17929,3814,0,3814,14115,650,13465,78.72720174,MR,47,47085
Hunt County,Texas,TX,76596,34206,0,34206,42390,1548,40842,55.34231553,MR,48,48231
Hunterdon County,New Jersey,NJ,121989,57233,48967,8266,64756,2280,62476,53.08347474,MR,34,34019
Huntingdon County,Pennsylvania,PA,45586,14011,0,14011,31575,1024,30551,69.26468653,MR,42,42061
Huntington County,Indiana,IN,38075,18397,86,18311,19678,1794,17884,51.68220617,MR,18,18069
Huron County,Michigan,MI,36079,3985,0,3985,32094,2869,29225,88.95479365,MR,26,26063
Huron County,Ohio,OH,59487,32029,0,32029,27458,1656,25802,46.1579841,MU,39,39077
Hutchinson County,South Dakota,SD,8075,0,0,0,8075,1885,6190,100,CR,46,46067
Hutchinson County,Texas,TX,23857,18277,0,18277,5580,172,5408,23.38936161,MU,48,48233
Hyde County,North Carolina,NC,5826,0,0,0,5826,49,5777,100,CR,37,37095
Hyde County,South Dakota,SD,1671,0,0,0,1671,369,1302,100,CR,46,46069
Iberia Parish,Louisiana,LA,73266,49536,1500,48036,23730,564,23166,32.38882974,MU,22,22045
Iberville Parish,Louisiana,LA,33320,16910,0,16910,16410,210,16200,49.24969988,MU,22,22047
Ida County,Iowa,IA,7837,0,0,0,7837,1068,6769,100,CR,19,19093
Idaho County,Idaho,ID,15511,3162,0,3162,12349,1163,11186,79.61446715,MR,16,16049
Imperial County,California,CA,142361,121303,53953,67350,21058,540,20518,14.79197252,MU,6,6025
Independence County,Arkansas,AR,34233,10746,0,10746,23487,1027,22460,68.6092367,MR,5,5063
Indian River County,Florida,FL,112947,103714,99919,3795,9233,247,8986,8.174630579,MU,12,12061
Indiana County,Pennsylvania,PA,89605,33959,0,33959,55646,1287,54359,62.10144523,MR,42,42063
Ingham County,Michigan,MI,279320,242299,236218,6081,37021,1781,35240,13.25397394,MU,26,26065
Inyo County,California,CA,17945,10403,0,10403,7542,65,7477,42.02842017,MU,6,6027
Ionia County,Michigan,MI,61518,26318,0,26318,35200,2336,32864,57.21902533,MR,26,26067
Iosco County,Michigan,MI,27339,11661,0,11661,15678,323,15355,57.34664765,MR,26,26069
Iowa County,Iowa,IA,15671,0,0,0,15671,1864,13807,100,CR,19,19095
Iowa County,Wisconsin,WI,22780,3920,0,3920,18860,2876,15984,82.79192274,MR,55,55049
Iredell County,North Carolina,NC,122660,61859,0,61859,60801,1474,59327,49.56872656,MU,37,37097
Irion County,Texas,TX,1771,0,0,0,1771,134,1637,100,CR,48,48235
Iron County,Michigan,MI,13138,3861,0,3861,9277,128,9149,70.61196529,MR,26,26071
Iron County,Missouri,MO,10697,2612,0,2612,8085,314,7771,75.58193886,MR,29,29093
Iron County,Utah,UT,33779,22253,0,22253,11526,140,11386,34.12179165,MU,49,49021
Iron County,Wisconsin,WI,6861,2148,0,2148,4713,58,4655,68.69261041,MR,55,55051
Iroquois County,Illinois,IL,31334,8660,0,8660,22674,2714,19960,72.36229016,MR,17,17075
Irwin County,Georgia,GA,9931,3140,0,3140,6791,323,6468,68.38183466,MR,13,13155
Isabella County,Michigan,MI,63351,31481,0,31481,31870,1874,29996,50.30701962,MR,26,26073
Isanti County,Minnesota,MN,31287,8327,0,8327,22960,1570,21390,73.38511203,MR,27,27059
Island County,Washington,WA,71558,37108,0,37108,34450,404,34046,48.14276531,MU,53,53029
Isle of Wight County,Virginia,VA,29728,10113,1308,8805,19615,632,18983,65.9815662,MR,51,51093
Issaquena County,Mississippi,MS,2274,0,0,0,2274,137,2137,100,CR,28,28055
Itasca County,Minnesota,MN,43992,8530,0,8530,35462,660,34802,80.61011093,MR,27,27061
Itawamba County,Mississippi,MS,22770,2749,0,2749,20021,545,19476,87.92709706,MR,28,28057
Izard County,Arkansas,AR,13249,0,0,0,13249,771,12478,100,CR,5,5065
Jack County,Texas,TX,8763,4227,0,4227,4536,429,4107,51.76309483,MR,48,48237
Jackson County,Alabama,AL,53926,12790,0,12790,41136,1079,40057,76.2823128,MR,1,1071
Jackson County,Arkansas,AR,18418,7039,0,7039,11379,255,11124,61.78195244,MR,5,5067
Jackson County,Colorado,CO,1577,0,0,0,1577,309,1268,100,CR,8,8057
Jackson County,Florida,FL,46755,7950,0,7950,38805,1530,37275,82.99647097,MR,12,12063
Jackson County,Georgia,GA,41589,4989,153,4836,36600,1021,35579,88.00403953,MR,13,13157
Jackson County,Illinois,IL,59612,37449,0,37449,22163,1114,21049,37.17875596,MU,17,17077
Jackson County,Indiana,IN,41335,23238,0,23238,18097,1726,16371,43.78129914,MU,18,18071
Jackson County,Iowa,IA,20296,9502,0,9502,10794,2441,8353,53.18289318,MR,19,19097
Jackson County,Kansas,KS,12657,3284,0,3284,9373,1673,7700,74.05388323,MR,20,20085
Jackson County,Kentucky,KY,13495,0,0,0,13495,906,12589,100,CR,21,21109
Jackson County,Michigan,MI,158422,92786,87913,4873,65636,2410,63226,41.43111437,MU,26,26075
Jackson County,Minnesota,MN,11268,3289,0,3289,7979,1881,6098,70.81114661,MR,27,27063
Jackson County,Mississippi,MS,131420,88959,88959,0,42461,429,42032,32.30938974,MU,28,28059
Jackson County,Missouri,MO,654880,628891,620932,7959,25989,1143,24846,3.968513315,MU,29,29095
Jackson County,North Carolina,NC,33121,7163,0,7163,25958,265,25693,78.37323752,MR,37,37099
Jackson County,Ohio,OH,32641,12478,0,12478,20163,587,19576,61.77200453,MR,39,39079
Jackson County,Oklahoma,OK,28439,21125,0,21125,7314,565,6749,25.71820387,MU,40,40065
Jackson County,Oregon,OR,181269,140462,128797,11665,40807,2389,38418,22.51184703,MU,41,41029
Jackson County,South Dakota,SD,2930,0,0,0,2930,368,2562,100,CR,46,46071
Jackson County,Tennessee,TN,10984,0,0,0,10984,734,10250,100,CR,47,47087
Jackson County,Texas,TX,14391,5805,0,5805,8586,528,8058,59.66228893,MR,48,48239
Jackson County,West Virginia,WV,28000,7679,0,7679,20321,813,19508,72.575,MR,54,54035
Jackson County,Wisconsin,WI,19100,5528,0,5528,13572,1515,12057,71.05759162,MR,55,55053
Jackson Parish,Louisiana,LA,15397,4949,0,4949,10448,264,10184,67.85737481,MR,22,22049
James City County,Virginia,VA,48102,34075,34075,0,14027,46,13981,29.16094965,MU,51,51095
Jasper County,Georgia,GA,11426,0,0,0,11426,501,10925,100,CR,13,13159
Jasper County,Illinois,IL,10117,3155,0,3155,6962,1342,5620,68.81486607,MR,17,17079
Jasper County,Indiana,IN,30043,11634,0,11634,18409,1262,17147,61.27550511,MR,18,18073
Jasper County,Iowa,IA,37213,16285,0,16285,20928,2180,18748,56.23841131,MR,19,19099
Jasper County,Mississippi,MS,18149,0,0,0,18149,898,17251,100,CR,28,28061
Jasper County,Missouri,MO,104686,78143,63950,14193,26543,2036,24507,25.35487076,MU,29,29097
Jasper County,South Carolina,SC,20678,3616,0,3616,17062,187,16875,82.51281555,MR,45,45053
Jasper County,Texas,TX,35604,8002,0,8002,27602,560,27042,77.52499719,MR,48,48241
Jay County,Indiana,IN,21806,9388,0,9388,12418,1970,10448,56.94762909,MR,18,18075
Jeff Davis County,Georgia,GA,12684,3927,0,3927,8757,446,8311,69.0397351,MR,13,13161
Jeff Davis County,Texas,TX,2207,0,0,0,2207,80,2127,100,CR,48,48243
Jefferson County,Alabama,AL,662047,591134,577383,13751,70913,936,69977,10.71117307,MU,1,1073
Jefferson County,Arkansas,AR,84278,58436,58436,0,25842,417,25425,30.66280643,MU,5,5069
Jefferson County,Colorado,CO,527056,491542,481237,10305,35514,581,34933,6.738183419,MU,8,8059
Jefferson County,Florida,FL,12902,0,0,0,12902,464,12438,100,CR,12,12065
Jefferson County,Georgia,GA,17266,3199,0,3199,14067,496,13571,81.47225762,MR,13,13163
Jefferson County,Idaho,ID,19155,3608,0,3608,15547,1459,14088,81.1641869,MR,16,16051
Jefferson County,Illinois,IL,40045,17482,0,17482,22563,1744,20819,56.34411287,MR,17,17081
Jefferson County,Indiana,IN,31705,17454,0,17454,14251,1595,12656,44.94874625,MU,18,18077
Jefferson County,Iowa,IA,16181,9351,0,9351,6830,1150,5680,42.20999938,MU,19,19101
Jefferson County,Kansas,KS,18426,0,0,0,18426,1571,16855,100,CR,20,20087
Jefferson County,Kentucky,KY,693604,680799,680799,0,12805,386,12419,1.84615429,MU,21,21111
Jefferson County,Mississippi,MS,9740,2775,0,2775,6965,227,6738,71.50924025,MR,28,28063
Jefferson County,Missouri,MO,198099,129150,116825,12325,68949,795,68154,34.80532461,MU,29,29099
Jefferson County,Montana,MT,10049,0,0,0,10049,465,9584,100,CR,30,30043
Jefferson County,Nebraska,NE,8333,4299,0,4299,4034,1036,2998,48.4099364,MU,31,31095
Jefferson County,New York,NY,111738,52721,0,52721,59017,1840,57177,52.81730477,MR,36,36045
Jefferson County,Ohio,OH,73894,44552,44552,0,29342,315,29027,39.70823071,MU,39,39081
Jefferson County,Oklahoma,OK,6818,0,0,0,6818,381,6437,100,CR,40,40067
Jefferson County,Oregon,OR,19009,7075,0,7075,11934,1058,10876,62.78078805,MR,41,41031
Jefferson County,Pennsylvania,PA,45932,15581,0,15581,30351,590,29761,66.07811548,MR,42,42065
Jefferson County,Tennessee,TN,44294,10951,10930,21,33343,1180,32163,75.27656116,MR,47,47089
Jefferson County,Texas,TX,252051,231060,225447,5613,20991,411,20580,8.328076461,MU,48,48245
Jefferson County,Washington,WA,25953,11627,0,11627,14326,244,14082,55.19978423,MR,53,53031
Jefferson County,West Virginia,WV,42190,13282,0,13282,28908,565,28343,68.5186063,MR,54,54037
Jefferson County,Wisconsin,WI,74021,42805,711,42094,31216,2146,29070,42.17181611,MU,55,55055
Jefferson Davis County,Mississippi,MS,13962,0,0,0,13962,486,13476,100,CR,28,28065
Jefferson Davis Parish,Louisiana,LA,31435,16316,0,16316,15119,670,14449,48.09607126,MU,22,22053
Jefferson Parish,Louisiana,LA,455466,451078,447697,3381,4388,2,4386,0.963408904,MU,22,22051
Jenkins County,Georgia,GA,8575,3090,0,3090,5485,289,5196,63.96501458,MR,13,13165
Jennings County,Indiana,IN,27554,11383,0,11383,16171,1397,14774,58.6883937,MR,18,18079
Jerauld County,South Dakota,SD,2295,0,0,0,2295,467,1828,100,CR,46,46073
Jerome County,Idaho,ID,18342,7863,0,7863,10479,1704,8775,57.13117435,MR,16,16053
Jersey County,Illinois,IL,21668,8277,0,8277,13391,983,12408,61.80081226,MR,17,17083
Jessamine County,Kentucky,KY,39041,27108,1763,25345,11933,1221,10712,30.56530314,MU,21,21113
Jewell County,Kansas,KS,3791,0,0,0,3791,829,2962,100,CR,20,20089
Jim Hogg County,Texas,TX,5281,4354,0,4354,927,43,884,17.55349366,MU,48,48247
Jim Wells County,Texas,TX,39326,24891,0,24891,14435,660,13775,36.70599603,MU,48,48249
Jo Daviess County,Illinois,IL,22289,6407,2915,3492,15882,1568,14314,71.25487909,MR,17,17085
Johnson County,Arkansas,AR,22781,5478,0,5478,17303,769,16534,75.95364558,MR,5,5071
Johnson County,Georgia,GA,8560,0,0,0,8560,260,8300,100,CR,13,13167
Johnson County,Illinois,IL,12878,2676,0,2676,10202,647,9555,79.22037583,MR,17,17087
Johnson County,Indiana,IN,115209,95795,95795,0,19414,828,18586,16.85111406,MU,18,18081
Johnson County,Iowa,IA,111006,85181,85181,0,25825,2924,22901,23.26450822,MU,19,19103
Johnson County,Kansas,KS,451086,428500,413138,15362,22586,981,21605,5.007027485,MU,20,20091
Johnson County,Kentucky,KY,23445,5978,0,5978,17467,262,17205,74.50202602,MR,21,21115
Johnson County,Missouri,MO,48258,24633,0,24633,23625,2471,21154,48.95561358,MU,29,29101
Johnson County,Nebraska,NE,4488,0,0,0,4488,705,3783,100,CR,31,31097
Johnson County,Tennessee,TN,17499,2857,0,2857,14642,890,13752,83.67335276,MR,47,47091
Johnson County,Texas,TX,126811,69710,24056,45654,57101,2660,54441,45.02842813,MU,48,48251
Johnson County,Wyoming,WY,7075,3672,0,3672,3403,667,2736,48.09893993,MU,56,56019
Johnston County,North Carolina,NC,121965,38588,0,38588,83377,2405,80972,68.36141516,MR,37,37101
Johnston County,Oklahoma,OK,10513,2869,0,2869,7644,585,7059,72.70997812,MR,40,40069
Jones County,Georgia,GA,23639,4342,4342,0,19297,603,18694,81.63204873,MR,13,13169
Jones County,Iowa,IA,20221,8911,0,8911,11310,2244,9066,55.93195193,MR,19,19105
Jones County,Mississippi,MS,64958,26153,0,26153,38805,1212,37593,59.73860033,MR,28,28067
Jones County,North Carolina,NC,10381,0,0,0,10381,402,9979,100,CR,37,37103
Jones County,South Dakota,SD,1193,0,0,0,1193,236,957,100,CR,46,46075
Jones County,Texas,TX,20785,8162,0,8162,12623,603,12020,60.73129661,MR,48,48253
Josephine County,Oregon,OR,75726,39267,0,39267,36459,721,35738,48.14594723,MU,41,41033
Juab County,Utah,UT,8238,4575,0,4575,3663,56,3607,44.46467589,MU,49,49023
Judith Basin County,Montana,MT,2329,0,0,0,2329,813,1516,100,CR,30,30045
Juneau City and Borough,Alaska,AK,30711,25074,0,25074,5637,44,5593,18.35498681,MU,2,2110
Juneau County,Wisconsin,WI,24316,3659,0,3659,20657,1346,19311,84.95229479,MR,55,55057
Juniata County,Pennsylvania,PA,22821,3340,0,3340,19481,1260,18221,85.36435739,MR,42,42067
Kalamazoo County,Michigan,MI,238603,191052,187830,3222,47551,1237,46314,19.92891959,MU,26,26077
Kalawao County,Hawaii,HI,147,0,0,0,147,0,147,100,CR,15,15005
Kalkaska County,Michigan,MI,16571,2807,0,2807,13764,241,13523,83.06076881,MR,26,26079
Kanabec County,Minnesota,MN,14996,3084,0,3084,11912,1106,10806,79.43451587,MR,27,27065
Kanawha County,West Virginia,WV,200073,150781,147871,2910,49292,178,49114,24.63700749,MU,54,54039
Kandiyohi County,Minnesota,MN,41203,22253,0,22253,18950,2279,16671,45.99179671,MU,27,27067
Kane County,Illinois,IL,404119,379072,376420,2652,25047,1202,23845,6.197926848,MU,17,17089
Kane County,Utah,UT,6046,2782,0,2782,3264,78,3186,53.98610652,MR,49,49025
Kankakee County,Illinois,IL,103833,75834,64978,10856,27999,1487,26512,26.96541562,MU,17,17091
Karnes County,Texas,TX,15446,9485,0,9485,5961,741,5220,38.59251586,MU,48,48255
Kauai County,Hawaii,HI,58463,47512,0,47512,10951,515,10436,18.7315054,MU,15,15007
Kaufman County,Texas,TX,71313,24130,8,24122,47183,2182,45001,66.16325214,MR,48,48257
Kay County,Oklahoma,OK,48080,35925,0,35925,12155,1305,10850,25.28078203,MU,40,40071
Kearney County,Nebraska,NE,6882,2885,0,2885,3997,797,3200,58.07904679,MR,31,31099
Kearny County,Kansas,KS,4531,0,0,0,4531,349,4182,100,CR,20,20093
Keith County,Nebraska,NE,8875,4581,0,4581,4294,554,3740,48.38309859,MU,31,31101
Kemper County,Mississippi,MS,10453,0,0,0,10453,654,9799,100,CR,28,28069
Kenai Peninsula Borough,Alaska,AK,49691,8132,0,8132,41559,302,41257,83.63486346,MR,2,2122
Kendall County,Illinois,IL,54544,40201,34395,5806,14343,1179,13164,26.29620123,MU,17,17093
Kendall County,Texas,TX,23743,8857,0,8857,14886,878,14008,62.69637367,MR,48,48259
Kenedy County,Texas,TX,414,0,0,0,414,62,352,100,CR,48,48261
Kennebec County,Maine,ME,117114,45395,0,45395,71719,880,70839,61.2386222,MR,23,23011
Kenosha County,Wisconsin,WI,149577,133070,131275,1795,16507,833,15674,11.03578759,MU,55,55059
Kent County,Delaware,DE,126697,81716,65048,16668,44981,1610,43371,35.5028138,MU,10,10001
Kent County,Maryland,MD,19197,5035,0,5035,14162,661,13501,73.77194353,MR,24,24029
Kent County,Michigan,MI,574335,489605,480529,9076,84730,1563,83167,14.75271401,MU,26,26081
Kent County,Rhode Island,RI,167090,155780,155780,0,11310,106,11204,6.76880723,MU,44,44003
Kent County,Texas,TX,859,0,0,0,859,155,704,100,CR,48,48263
Kenton County,Kentucky,KY,151464,140308,140308,0,11156,630,10526,7.365446575,MU,21,21117
Keokuk County,Iowa,IA,11400,0,0,0,11400,1443,9957,100,CR,19,19107
Kern County,California,CA,661645,584365,396348,188017,77280,1827,75453,11.67997945,MU,6,6029
Kerr County,Texas,TX,43653,26551,0,26551,17102,748,16354,39.17714705,MU,48,48265
Kershaw County,South Carolina,SC,52647,19969,2610,17359,32678,637,32041,62.07001349,MR,45,45055
Ketchikan Gateway Borough,Alaska,AK,14070,10759,0,10759,3311,13,3298,23.53233831,MU,2,2130
Kewaunee County,Wisconsin,WI,20187,3579,0,3579,16608,1628,14980,82.27076832,MR,55,55061
Keweenaw County,Michigan,MI,2301,0,0,0,2301,0,2301,100,CR,26,26083
Keya Paha County,Nebraska,NE,983,0,0,0,983,412,571,100,CR,31,31103
Kidder County,North Dakota,ND,2753,0,0,0,2753,872,1881,100,CR,38,38043
Kimball County,Nebraska,NE,4089,2559,0,2559,1530,323,1207,37.41746148,MU,31,31105
Kimble County,Texas,TX,4468,2656,0,2656,1812,500,1312,40.55505819,MU,48,48267
King and Queen County,Virginia,VA,6630,0,0,0,6630,348,6282,100,CR,51,51097
King County,Texas,TX,356,0,0,0,356,62,294,100,CR,48,48269
King County,Washington,WA,1737034,1672064,1658592,13472,64970,1167,63803,3.740283725,MU,53,53033
King George County,Virginia,VA,16803,0,0,0,16803,244,16559,100,CR,51,51099
King William County,Virginia,VA,13146,2547,0,2547,10599,423,10176,80.62528526,MR,51,51101
Kingfisher County,Oklahoma,OK,13926,4054,0,4054,9872,1059,8813,70.88898463,MR,40,40073
Kingman County,Kansas,KS,8673,3195,0,3195,5478,1205,4273,63.1615358,MR,20,20095
Kings County,California,CA,129461,112500,0,112500,16961,2520,14441,13.10124285,MU,6,6031
Kings County,New York,NY,2465326,2465326,2465326,0,0,0,0,0,MU,36,36047
Kingsbury County,South Dakota,SD,5815,0,0,0,5815,1008,4807,100,CR,46,46077
Kinney County,Texas,TX,3379,0,0,0,3379,130,3249,100,CR,48,48271
Kiowa County,Colorado,CO,1622,0,0,0,1622,288,1334,100,CR,8,8061
Kiowa County,Kansas,KS,3278,0,0,0,3278,405,2873,100,CR,20,20097
Kiowa County,Oklahoma,OK,10227,3721,0,3721,6506,605,5901,63.61591865,MR,40,40075
Kit Carson County,Colorado,CO,8011,3709,0,3709,4302,943,3359,53.7011609,MR,8,8063
Kitsap County,Washington,WA,231969,186388,179271,7117,45581,319,45262,19.64960835,MU,53,53035
Kittitas County,Washington,WA,33362,19845,0,19845,13517,1137,12380,40.51615611,MU,53,53037
Kittson County,Minnesota,MN,5285,0,0,0,5285,639,4646,100,CR,27,27069
Klamath County,Oregon,OR,63775,41119,0,41119,22656,1965,20691,35.5248922,MU,41,41035
Kleberg County,Texas,TX,31549,25649,0,25649,5900,178,5722,18.70106818,MU,48,48273
Klickitat County,Washington,WA,19161,7997,0,7997,11164,846,10318,58.26418245,MR,53,53039
Knott County,Kentucky,KY,17649,0,0,0,17649,74,17575,100,CR,21,21119
Knox County,Illinois,IL,55836,41983,0,41983,13853,1417,12436,24.81015832,MU,17,17095
Knox County,Indiana,IN,39256,25141,0,25141,14115,1207,12908,35.95628694,MU,18,18083
Knox County,Kentucky,KY,31795,9372,0,9372,22423,557,21866,70.52366724,MR,21,21121
Knox County,Maine,ME,39618,15196,0,15196,24422,355,24067,61.64369731,MR,23,23013
Knox County,Missouri,MO,4361,0,0,0,4361,852,3509,100,CR,29,29103
Knox County,Nebraska,NE,9374,0,0,0,9374,1941,7433,100,CR,31,31107
Knox County,Ohio,OH,54500,22635,0,22635,31865,2649,29216,58.46788991,MR,39,39083
Knox County,Tennessee,TN,382032,332094,332094,0,49938,857,49081,13.07167986,MU,47,47093
Knox County,Texas,TX,4253,0,0,0,4253,216,4037,100,CR,48,48275
Kodiak Island Borough,Alaska,AK,13913,10567,0,10567,3346,10,3336,24.04945015,MU,2,2150
Koochiching County,Minnesota,MN,14355,7790,0,7790,6565,348,6217,45.73319401,MU,27,27071
Kootenai County,Idaho,ID,108685,79904,75063,4841,28781,873,27908,26.48111515,MU,16,16055
Kosciusko County,Indiana,IN,74057,34502,0,34502,39555,3314,36241,53.41156136,MR,18,18085
Kossuth County,Iowa,IA,17163,5898,0,5898,11265,2186,9079,65.63537843,MR,19,19109
La Crosse County,Wisconsin,WI,107120,88992,84235,4757,18128,1394,16734,16.92307692,MU,55,55063
La Paz County,Arizona,AZ,19715,8547,0,8547,11168,74,11094,56.64722293,MR,4,4012
La Plata County,Colorado,CO,43941,15493,0,15493,28448,1401,27047,64.74135773,MR,8,8067
La Salle County,Illinois,IL,111509,77659,0,77659,33850,2520,31330,30.35629411,MU,17,17099
La Salle County,Texas,TX,5866,4478,0,4478,1388,91,1297,23.66177975,MU,48,48283
La Salle Parish,Louisiana,LA,14282,3887,0,3887,10395,191,10204,72.78392382,MR,22,22059
Labette County,Kansas,KS,22835,11143,0,11143,11692,1517,10175,51.20210204,MR,20,20099
Lac qui Parle County,Minnesota,MN,8067,0,0,0,8067,2036,6031,100,CR,27,27073
Lackawanna County,Pennsylvania,PA,213295,175984,175984,0,37311,397,36914,17.49267446,MU,42,42069
Laclede County,Missouri,MO,32513,11670,0,11670,20843,1876,18967,64.10666503,MR,29,29105
Lafayette County,Arkansas,AR,8559,0,0,0,8559,414,8145,100,CR,5,5073
Lafayette County,Florida,FL,7022,0,0,0,7022,328,6694,100,CR,12,12067
Lafayette County,Mississippi,MS,38744,19665,0,19665,19079,341,18738,49.24375387,MU,28,28071
Lafayette County,Missouri,MO,32960,13580,0,13580,19380,2196,17184,58.79854369,MR,29,29107
Lafayette County,Wisconsin,WI,16137,0,0,0,16137,2657,13480,100,CR,55,55065
Lafayette Parish,Louisiana,LA,190503,167642,167642,0,22861,395,22466,12.00033595,MU,22,22055
Lafourche Parish,Louisiana,LA,89974,64950,44558,20392,25024,463,24561,27.81247916,MU,22,22057
LaGrange County,Indiana,IN,34909,3245,0,3245,31664,4707,26957,90.70440288,MR,18,18087
Lake and Peninsula Borough,Alaska,AK,1823,0,0,0,1823,20,1803,100,CR,2,2164
Lake County,California,CA,58309,32393,0,32393,25916,822,25094,44.44596889,MU,6,6033
Lake County,Colorado,CO,7812,6100,0,6100,1712,0,1712,21.91500256,MU,8,8065
Lake County,Florida,FL,210528,146582,116365,30217,63946,1169,62777,30.37410701,MU,12,12069
Lake County,Illinois,IL,644356,633330,633330,0,11026,149,10877,1.711165877,MU,17,17097
Lake County,Indiana,IN,484564,462042,449730,12312,22522,792,21730,4.647889649,MU,18,18089
Lake County,Michigan,MI,11333,0,0,0,11333,253,11080,100,CR,26,26085
Lake County,Minnesota,MN,11058,3422,0,3422,7636,42,7594,69.0540785,MR,27,27075
Lake County,Montana,MT,26507,4116,0,4116,22391,1942,20449,84.47202626,MR,30,30047
Lake County,Ohio,OH,227511,209618,209618,0,17893,315,17578,7.864674675,MU,39,39085
Lake County,Oregon,OR,7422,3194,0,3194,4228,691,3537,56.96577742,MR,41,41037
Lake County,South Dakota,SD,11276,6281,0,6281,4995,1046,3949,44.29762327,MU,46,46079
Lake County,Tennessee,TN,7954,0,0,0,7954,24,7930,100,CR,47,47095
Lake of the Woods County,Minnesota,MN,4522,0,0,0,4522,296,4226,100,CR,27,27077
Lamar County,Alabama,AL,15904,0,0,0,15904,336,15568,100,CR,1,1075
Lamar County,Georgia,GA,15912,6823,0,6823,9089,383,8706,57.12041227,MR,13,13171
Lamar County,Mississippi,MS,39070,12664,12664,0,26406,517,25889,67.58638341,MR,28,28073
Lamar County,Texas,TX,48499,26274,0,26274,22225,1238,20987,45.82568713,MU,48,48277
Lamb County,Texas,TX,14709,6234,0,6234,8475,668,7807,57.61778503,MR,48,48279
Lamoille County,Vermont,VT,23233,0,0,0,23233,514,22719,100,CR,50,50015
LaMoure County,North Dakota,ND,4701,0,0,0,4701,1001,3700,100,CR,38,38045
Lampasas County,Texas,TX,17762,6994,141,6853,10768,894,9874,60.62380363,MR,48,48281
Lancaster County,Nebraska,NE,250291,226460,226460,0,23831,3077,20754,9.521317187,MU,31,31109
Lancaster County,Pennsylvania,PA,470658,354537,323285,31252,116121,13494,102627,24.67205487,MU,42,42071
Lancaster County,South Carolina,SC,61351,23705,0,23705,37646,804,36842,61.361673,MR,45,45057
Lancaster County,Virginia,VA,11567,0,0,0,11567,366,11201,100,CR,51,51103
Lander County,Nevada,NV,5794,3791,0,3791,2003,26,1977,34.57024508,MU,32,32015
Lane County,Kansas,KS,2155,0,0,0,2155,212,1943,100,CR,20,20101
Lane County,Oregon,OR,322959,260248,223858,36390,62711,3636,59075,19.41763506,MU,41,41039
Langlade County,Wisconsin,WI,20740,8930,0,8930,11810,724,11086,56.94310511,MR,55,55067
Lanier County,Georgia,GA,7241,431,0,431,6810,258,6552,94.04778346,MR,13,13173
Lapeer County,Michigan,MI,87904,21038,0,21038,66866,1944,64922,76.06707317,MR,26,26087
LaPorte County,Indiana,IN,110106,71090,64835,6255,39016,1916,37100,35.43494451,MU,18,18091
Laramie County,Wyoming,WY,81607,68117,68117,0,13490,967,12523,16.53044469,MU,56,56021
Larimer County,Colorado,CO,251494,217450,207008,10442,34044,2758,31286,13.53670465,MU,8,8069
Larue County,Kentucky,KY,13373,3112,0,3112,10261,1595,8666,76.72923054,MR,21,21123
Las Animas County,Colorado,CO,15207,9341,0,9341,5866,515,5351,38.57434076,MU,8,8071
Lassen County,California,CA,33828,13936,0,13936,19892,364,19528,58.80335816,MR,6,6035
Latah County,Idaho,ID,34935,21770,0,21770,13165,1025,12140,37.68427079,MU,16,16057
Latimer County,Oklahoma,OK,10692,3063,0,3063,7629,667,6962,71.35241302,MR,40,40077
Lauderdale County,Alabama,AL,87966,42402,42402,0,45564,1184,44380,51.79728531,MR,1,1077
Lauderdale County,Mississippi,MS,78161,40738,0,40738,37423,564,36859,47.87937718,MU,28,28075
Lauderdale County,Tennessee,TN,27101,10946,0,10946,16155,359,15796,59.61034648,MR,47,47097
Laurel County,Kentucky,KY,52715,17127,0,17127,35588,1074,34514,67.51019634,MR,21,21125
Laurens County,Georgia,GA,44874,19241,0,19241,25633,627,25006,57.12216428,MR,13,13175
Laurens County,South Carolina,SC,69567,23895,1490,22405,45672,1315,44357,65.65181767,MR,45,45059
Lavaca County,Texas,TX,19210,3498,0,3498,15712,2212,13500,81.79073399,MR,48,48285
Lawrence County,Alabama,AL,34803,2595,86,2509,32208,1480,30728,92.54374623,MR,1,1079
Lawrence County,Arkansas,AR,17774,6315,0,6315,11459,508,10951,64.470575,MR,5,5075
Lawrence County,Illinois,IL,15452,7919,0,7919,7533,855,6678,48.75097075,MU,17,17101
Lawrence County,Indiana,IN,45922,20278,0,20278,25644,999,24645,55.84251557,MR,18,18093
Lawrence County,Kentucky,KY,15569,3423,0,3423,12146,548,11598,78.01400218,MR,21,21127
Lawrence County,Mississippi,MS,13258,0,0,0,13258,601,12657,100,CR,28,28077
Lawrence County,Missouri,MO,35204,13485,0,13485,21719,2824,18895,61.69469378,MR,29,29109
Lawrence County,Ohio,OH,62319,32483,32483,0,29836,561,29275,47.87624962,MU,39,39087
Lawrence County,Pennsylvania,PA,94643,55762,10224,45538,38881,1112,37769,41.08174931,MU,42,42073
Lawrence County,South Dakota,SD,21802,14294,0,14294,7508,547,6961,34.4372076,MU,46,46081
Lawrence County,Tennessee,TN,39926,9987,0,9987,29939,1999,27940,74.98622452,MR,47,47099
Le Flore County,Oklahoma,OK,48109,14787,2138,12649,33322,1861,31461,69.26354736,MR,40,40079
Le Sueur County,Minnesota,MN,25426,9183,0,9183,16243,1853,14390,63.88342641,MR,27,27079
Lea County,New Mexico,NM,55511,43665,0,43665,11846,377,11469,21.33991461,MU,35,35025
Leake County,Mississippi,MS,20940,3875,0,3875,17065,989,16076,81.4947469,MR,28,28079
Leavenworth County,Kansas,KS,68691,46845,0,46845,21846,1597,20249,31.80329301,MU,20,20103
Lebanon County,Pennsylvania,PA,120327,82944,79755,3189,37383,2159,35224,31.06784014,MU,42,42075
Lee County,Alabama,AL,115092,76956,76956,0,38136,697,37439,33.13523095,MU,1,1081
Lee County,Arkansas,AR,12580,5163,0,5163,7417,343,7074,58.95866455,MR,5,5077
Lee County,Florida,FL,440888,389988,362769,27219,50900,418,50482,11.54488215,MU,12,12071
Lee County,Georgia,GA,24757,12472,12472,0,12285,236,12049,49.62232904,MU,13,13177
Lee County,Illinois,IL,36062,20135,0,20135,15927,1627,14300,44.16560368,MU,17,17103
Lee County,Iowa,IA,38052,22682,0,22682,15370,1530,13840,40.39209503,MU,19,19111
Lee County,Kentucky,KY,7916,0,0,0,7916,131,7785,100,CR,21,21129
Lee County,Mississippi,MS,75755,40758,0,40758,34997,857,34140,46.19761072,MU,28,28081
Lee County,North Carolina,NC,49040,25443,0,25443,23597,431,23166,48.11786297,MU,37,37105
Lee County,South Carolina,SC,20119,3767,0,3767,16352,720,15632,81.27640539,MR,45,45061
Lee County,Texas,TX,15657,4614,0,4614,11043,1629,9414,70.53075302,MR,48,48287
Lee County,Virginia,VA,23589,108,0,108,23481,1627,21854,99.54215948,MR,51,51105
Leelanau County,Michigan,MI,21119,1055,0,1055,20064,595,19469,95.00449832,MR,26,26089
Leflore County,Mississippi,MS,37947,29849,0,29849,8098,239,7859,21.34029041,MU,28,28083
Lehigh County,Pennsylvania,PA,312090,281907,281907,0,30183,524,29659,9.671248678,MU,42,42077
Lemhi County,Idaho,ID,7806,3000,0,3000,4806,549,4257,61.5680246,MR,16,16059
Lenawee County,Michigan,MI,98890,45250,0,45250,53640,2862,50778,54.24208717,MR,26,26091
Lenoir County,North Carolina,NC,59648,33011,0,33011,26637,923,25714,44.65698766,MU,37,37107
Leon County,Florida,FL,239452,204857,204857,0,34595,600,33995,14.44757196,MU,12,12073
Leon County,Texas,TX,15335,0,0,0,15335,1233,14102,100,CR,48,48289
Leslie County,Kentucky,KY,12401,0,0,0,12401,172,12229,100,CR,21,21131
Letcher County,Kentucky,KY,25277,78,0,78,25199,218,24981,99.69141908,MR,21,21133
Levy County,Florida,FL,34450,0,0,0,34450,679,33771,100,CR,12,12075
Lewis and Clark County,Montana,MT,55716,38544,0,38544,17172,803,16369,30.82059014,MU,30,30049
Lewis County,Idaho,ID,3747,0,0,0,3747,142,3605,100,CR,16,16061
Lewis County,Kentucky,KY,14092,0,0,0,14092,1310,12782,100,CR,21,21135
Lewis County,Missouri,MO,10494,0,0,0,10494,953,9541,100,CR,29,29111
Lewis County,New York,NY,26944,3393,0,3393,23551,1405,22146,87.40721496,MR,36,36049
Lewis County,Tennessee,TN,11367,3201,0,3201,8166,302,7864,71.8395355,MR,47,47101
Lewis County,Washington,WA,68600,24634,0,24634,43966,1368,42598,64.09037901,MR,53,53041
Lewis County,West Virginia,WV,16919,5104,0,5104,11815,403,11412,69.83273243,MR,54,54041
Lexington city,Virginia,VA,6867,6867,0,6867,0,0,0,0,MU,51,51678
Lexington County,South Carolina,SC,216014,143177,138417,4760,72837,1257,71580,33.71864787,MU,45,45063
Liberty County,Florida,FL,7021,0,0,0,7021,43,6978,100,CR,12,12077
Liberty County,Georgia,GA,61610,49376,49376,0,12234,207,12027,19.85716604,MU,13,13179
Liberty County,Montana,MT,2158,0,0,0,2158,416,1742,100,CR,30,30051
Liberty County,Texas,TX,70154,25202,0,25202,44952,1391,43561,64.07617527,MR,48,48291
Licking County,Ohio,OH,145491,88231,77727,10504,57260,2666,54594,39.35638631,MU,39,39089
Limestone County,Alabama,AL,65676,21888,3359,18529,43788,1388,42400,66.67275717,MR,1,1083
Limestone County,Texas,TX,22051,10316,0,10316,11735,838,10897,53.21754115,MR,48,48293
Lincoln County,Arkansas,AR,14492,0,0,0,14492,314,14178,100,CR,5,5079
Lincoln County,Colorado,CO,6087,0,0,0,6087,780,5307,100,CR,8,8073
Lincoln County,Georgia,GA,8348,0,0,0,8348,200,8148,100,CR,13,13181
Lincoln County,Idaho,ID,4044,0,0,0,4044,709,3335,100,CR,16,16063
Lincoln County,Kansas,KS,3578,0,0,0,3578,828,2750,100,CR,20,20105
Lincoln County,Kentucky,KY,23361,4573,0,4573,18788,2203,16585,80.42463936,MR,21,21137
Lincoln County,Maine,ME,33616,0,0,0,33616,538,33078,100,CR,23,23015
Lincoln County,Minnesota,MN,6429,0,0,0,6429,1482,4947,100,CR,27,27081
Lincoln County,Mississippi,MS,33166,11937,0,11937,21229,607,20622,64.00832178,MR,28,28085
Lincoln County,Missouri,MO,38944,8184,0,8184,30760,1712,29048,78.98520953,MR,29,29113
Lincoln County,Montana,MT,18837,4204,0,4204,14633,256,14377,77.68222116,MR,30,30053
Lincoln County,Nebraska,NE,34632,24068,0,24068,10564,1565,8999,30.5035805,MU,31,31111
Lincoln County,Nevada,NV,4165,0,0,0,4165,62,4103,100,CR,32,32017
Lincoln County,New Mexico,NM,19411,9251,0,9251,10160,309,9851,52.34145588,MR,35,35027
Lincoln County,North Carolina,NC,63780,24173,0,24173,39607,563,39044,62.0994042,MR,37,37109
Lincoln County,Oklahoma,OK,32080,2467,0,2467,29613,2346,27267,92.30985037,MR,40,40081
Lincoln County,Oregon,OR,44479,27568,0,27568,16911,500,16411,38.0201893,MU,41,41041
Lincoln County,South Dakota,SD,24131,9461,6690,2771,14670,1774,12896,60.79317061,MR,46,46083
Lincoln County,Tennessee,TN,31340,6746,0,6746,24594,2038,22556,78.4747926,MR,47,47103
Lincoln County,Washington,WA,10184,0,0,0,10184,1092,9092,100,CR,53,53043
Lincoln County,West Virginia,WV,22108,0,0,0,22108,363,21745,100,CR,54,54043
Lincoln County,Wisconsin,WI,29641,13223,0,13223,16418,777,15641,55.38949428,MR,55,55069
Lincoln County,Wyoming,WY,14573,2958,0,2958,11615,718,10897,79.70218898,MR,56,56023
Lincoln Parish,Louisiana,LA,42509,26988,0,26988,15521,471,15050,36.51226799,MU,22,22061
Linn County,Iowa,IA,191701,160439,155423,5016,31262,3146,28116,16.30768749,MU,19,19113
Linn County,Kansas,KS,9570,0,0,0,9570,914,8656,100,CR,20,20107
Linn County,Missouri,MO,13754,4409,0,4409,9345,1124,8221,67.94387087,MR,29,29115
Linn County,Oregon,OR,103069,65424,0,65424,37645,3564,34081,36.5240761,MU,41,41043
Lipscomb County,Texas,TX,3057,0,0,0,3057,233,2824,100,CR,48,48295
Litchfield County,Connecticut,CT,182193,102230,59999,42231,79963,1061,78902,43.88917247,MU,9,9005
Little River County,Arkansas,AR,13628,3731,0,3731,9897,406,9491,72.62254183,MR,5,5081
Live Oak County,Texas,TX,12309,2470,0,2470,9839,481,9358,79.93338208,MR,48,48297
Livingston County,Illinois,IL,39678,23335,0,23335,16343,2253,14090,41.18907203,MU,17,17105
Livingston County,Kentucky,KY,9804,0,0,0,9804,419,9385,100,CR,21,21139
Livingston County,Michigan,MI,156951,96117,91847,4270,60834,998,59836,38.75986773,MU,26,26093
Livingston County,Missouri,MO,14558,9137,0,9137,5421,1287,4134,37.23725787,MU,29,29117
Livingston County,New York,NY,64328,29082,0,29082,35246,984,34262,54.79107076,MR,36,36051
Livingston Parish,Louisiana,LA,91814,41817,39618,2199,49997,664,49333,54.45465833,MR,22,22063
Llano County,Texas,TX,17044,7583,0,7583,9461,420,9041,55.50927012,MR,48,48299
Logan County,Arkansas,AR,22486,6486,0,6486,16000,910,15090,71.15538557,MR,5,5083
Logan County,Colorado,CO,20504,12196,0,12196,8308,1556,6752,40.51892314,MU,8,8075
Logan County,Illinois,IL,31183,18287,0,18287,12896,1212,11684,41.35586698,MU,17,17107
Logan County,Kansas,KS,3046,0,0,0,3046,272,2774,100,CR,20,20109
Logan County,Kentucky,KY,26573,6690,0,6690,19883,2166,17717,74.82406954,MR,21,21141
Logan County,Nebraska,NE,774,0,0,0,774,283,491,100,CR,31,31113
Logan County,North Dakota,ND,2308,0,0,0,2308,568,1740,100,CR,38,38047
Logan County,Ohio,OH,46005,20431,0,20431,25574,2322,23252,55.58960983,MR,39,39091
Logan County,Oklahoma,OK,33924,10899,2698,8201,23025,1124,21901,67.87230279,MR,40,40083
Logan County,West Virginia,WV,37710,8620,0,8620,29090,264,28826,77.14134182,MR,54,54045
Long County,Georgia,GA,10304,1052,1052,0,9252,108,9144,89.79037267,MR,13,13183
Lonoke County,Arkansas,AR,52828,23880,14364,9516,28948,844,28104,54.79669872,MR,5,5085
Lorain County,Ohio,OH,284664,238200,233955,4245,46464,1648,44816,16.32240115,MU,39,39093
Los Alamos County,New Mexico,NM,18343,16215,0,16215,2128,0,2128,11.60115575,MU,35,35028
Los Angeles County,California,CA,9519338,9451949,9418374,33575,67389,699,66690,0.707916874,MU,6,6037
Loudon County,Tennessee,TN,39086,19568,12586,6982,19518,1067,18451,49.93603848,MU,47,47105
Loudoun County,Virginia,VA,169599,142993,135641,7352,26606,1978,24628,15.6875925,MU,51,51107
Louisa County,Iowa,IA,12183,0,0,0,12183,1185,10998,100,CR,19,19115
Louisa County,Virginia,VA,25627,0,0,0,25627,1089,24538,100,CR,51,51109
Loup County,Nebraska,NE,712,0,0,0,712,256,456,100,CR,31,31115
Love County,Oklahoma,OK,8831,0,0,0,8831,514,8317,100,CR,40,40085
Loving County,Texas,TX,67,0,0,0,67,7,60,100,CR,48,48301
Lowndes County,Alabama,AL,13473,0,0,0,13473,540,12933,100,CR,1,1085
Lowndes County,Georgia,GA,92115,62572,57495,5077,29543,879,28664,32.07186669,MU,13,13185
Lowndes County,Mississippi,MS,61586,37143,0,37143,24443,825,23618,39.68921508,MU,28,28087
Lubbock County,Texas,TX,242628,212184,202190,9994,30444,1308,29136,12.54760374,MU,48,48303
Lucas County,Iowa,IA,9422,4421,0,4421,5001,894,4107,53.07790278,MR,19,19117
Lucas County,Ohio,OH,455054,429930,426824,3106,25124,1070,24054,5.52110299,MU,39,39095
Luce County,Michigan,MI,7024,3252,0,3252,3772,110,3662,53.70159453,MR,26,26095
Lumpkin County,Georgia,GA,21016,2978,0,2978,18038,465,17573,85.82984393,MR,13,13187
Luna County,New Mexico,NM,25016,14971,0,14971,10045,335,9710,40.15430125,MU,35,35029
Lunenburg County,Virginia,VA,13146,0,0,0,13146,398,12748,100,CR,51,51111
Luzerne County,Pennsylvania,PA,319250,254164,250601,3563,65086,575,64511,20.3871574,MU,42,42079
Lycoming County,Pennsylvania,PA,120044,76844,58580,18264,43200,1495,41705,35.98680484,MU,42,42081
Lyman County,South Dakota,SD,3895,0,0,0,3895,507,3388,100,CR,46,46085
Lynchburg city,Virginia,VA,65269,63295,63295,0,1974,0,1974,3.024406686,MU,51,51680
Lynn County,Texas,TX,6550,2825,0,2825,3725,433,3292,56.87022901,MR,48,48305
Lyon County,Iowa,IA,11763,0,0,0,11763,1906,9857,100,CR,19,19119
Lyon County,Kansas,KS,35935,26798,0,26798,9137,1406,7731,25.42646445,MU,20,20111
Lyon County,Kentucky,KY,8080,0,0,0,8080,291,7789,100,CR,21,21143
Lyon County,Minnesota,MN,25425,12600,0,12600,12825,2088,10737,50.44247788,MR,27,27083
Lyon County,Nevada,NV,34501,17016,1112,15904,17485,910,16575,50.67969044,MR,32,32019
Mackinac County,Michigan,MI,11943,2725,0,2725,9218,132,9086,77.18328728,MR,26,26097
Macomb County,Michigan,MI,788149,762702,757634,5068,25447,701,24746,3.228704217,MU,26,26099
Macon County,Alabama,AL,24105,12210,0,12210,11895,457,11438,49.34660859,MU,1,1087
Macon County,Georgia,GA,14074,5929,0,5929,8145,536,7609,57.87267301,MR,13,13193
Macon County,Illinois,IL,114706,96544,96544,0,18162,1003,17159,15.83352222,MU,17,17115
Macon County,Missouri,MO,15762,5063,0,5063,10699,1624,9075,67.87844182,MR,29,29121
Macon County,North Carolina,NC,29811,5620,0,5620,24191,339,23852,81.14789843,MR,37,37113
Macon County,Tennessee,TN,20386,3765,0,3765,16621,2003,14618,81.53144315,MR,47,47111
Macoupin County,Illinois,IL,49019,20349,0,20349,28670,2561,26109,58.48752525,MR,17,17117
Madera County,California,CA,123109,81193,58107,23086,41916,2860,39056,34.04787627,MU,6,6039
Madison County,Alabama,AL,276700,213287,209245,4042,63413,1461,61952,22.91760029,MU,1,1089
Madison County,Arkansas,AR,14243,0,0,0,14243,1810,12433,100,CR,5,5087
Madison County,Florida,FL,18733,4276,0,4276,14457,743,13714,77.17397107,MR,12,12079
Madison County,Georgia,GA,25730,1025,1025,0,24705,1038,23667,96.01632336,MR,13,13195
Madison County,Idaho,ID,27467,19137,0,19137,8330,850,7480,30.32730185,MU,16,16065
Madison County,Illinois,IL,258941,221137,211744,9393,37804,2298,35506,14.59946474,MU,17,17119
Madison County,Indiana,IN,133358,101995,91817,10178,31363,1489,29874,23.51789919,MU,18,18095
Madison County,Iowa,IA,14019,4858,0,4858,9161,1944,7217,65.34702903,MR,19,19121
Madison County,Kentucky,KY,70872,41554,0,41554,29318,1727,27591,41.36753584,MU,21,21151
Madison County,Mississippi,MS,74674,49785,36381,13404,24889,621,24268,33.33020864,MU,28,28089
Madison County,Missouri,MO,11800,4109,0,4109,7691,200,7491,65.1779661,MR,29,29123
Madison County,Montana,MT,6851,0,0,0,6851,814,6037,100,CR,30,30057
Madison County,Nebraska,NE,35226,24540,0,24540,10686,1455,9231,30.33554761,MU,31,31119
Madison County,New York,NY,69441,29004,2262,26742,40437,1466,38971,58.23216832,MR,36,36053
Madison County,North Carolina,NC,19635,0,0,0,19635,1273,18362,100,CR,37,37115
Madison County,Ohio,OH,40213,20723,103,20620,19490,1637,17853,48.46691368,MU,39,39097
Madison County,Tennessee,TN,91837,65531,64894,637,26306,894,25412,28.64422836,MU,47,47113
Madison County,Texas,TX,12940,3980,0,3980,8960,692,8268,69.24265842,MR,48,48313
Madison County,Virginia,VA,12520,0,0,0,12520,742,11778,100,CR,51,51113
Madison Parish,Louisiana,LA,13728,10604,0,10604,3124,265,2859,22.75641026,MU,22,22065
Magoffin County,Kentucky,KY,13332,0,0,0,13332,346,12986,100,CR,21,21153
Mahaska County,Iowa,IA,22335,12101,0,12101,10234,1884,8350,45.82046116,MU,19,19123
Mahnomen County,Minnesota,MN,5190,0,0,0,5190,739,4451,100,CR,27,27087
Mahoning County,Ohio,OH,257555,220581,212326,8255,36974,1170,35804,14.35576867,MU,39,39099
Major County,Oklahoma,OK,7545,0,0,0,7545,929,6616,100,CR,40,40093
Malheur County,Oregon,OR,31615,18799,0,18799,12816,2906,9910,40.53771944,MU,41,41045
Manassas city,Virginia,VA,35135,35115,35115,0,20,0,20,0.056923296,MU,51,51683
Manassas Park city,Virginia,VA,10290,10290,10290,0,0,0,0,0,MU,51,51685
Manatee County,Florida,FL,264002,242587,242587,0,21415,789,20626,8.111680972,MU,12,12081
Manistee County,Michigan,MI,24527,9997,0,9997,14530,438,14092,59.24083663,MR,26,26101
Manitowoc County,Wisconsin,WI,82887,50552,0,50552,32335,2817,29518,39.01094261,MU,55,55071
Marathon County,Wisconsin,WI,125834,69405,68281,1124,56429,5861,50568,44.84400083,MU,55,55073
Marengo County,Alabama,AL,22539,6649,0,6649,15890,448,15442,70.50002218,MR,1,1091
Maricopa County,Arizona,AZ,3072149,2981673,2935276,46397,90476,1557,88919,2.94503945,MU,4,4013
Maries County,Missouri,MO,8903,0,0,0,8903,1253,7650,100,CR,29,29125
Marin County,California,CA,247289,232902,232902,0,14387,760,13627,5.81788919,MU,6,6041
Marinette County,Wisconsin,WI,43384,17348,0,17348,26036,981,25055,60.01290798,MR,55,55075
Marion County,Alabama,AL,31214,94,0,94,31120,541,30579,99.69885308,MR,1,1093
Marion County,Arkansas,AR,16140,0,0,0,16140,405,15735,100,CR,5,5089
Marion County,Florida,FL,258916,158171,132957,25214,100745,2620,98125,38.91030296,MU,12,12083
Marion County,Georgia,GA,7144,0,0,0,7144,295,6849,100,CR,13,13197
Marion County,Illinois,IL,41691,24326,0,24326,17365,1329,16036,41.65167542,MU,17,17121
Marion County,Indiana,IN,860454,851873,851873,0,8581,273,8308,0.997264235,MU,18,18097
Marion County,Iowa,IA,32052,16854,0,16854,15198,1873,13325,47.41669787,MU,19,19125
Marion County,Kansas,KS,13361,2763,0,2763,10598,1843,8755,79.32041015,MR,20,20115
Marion County,Kentucky,KY,18212,5503,0,5503,12709,1863,10846,69.78365913,MR,21,21155
Marion County,Mississippi,MS,25595,7925,0,7925,17670,433,17237,69.03692127,MR,28,28091
Marion County,Missouri,MO,28289,21198,0,21198,7091,953,6138,25.06628018,MU,29,29127
Marion County,Ohio,OH,66217,45664,0,45664,20553,1253,19300,31.03885709,MU,39,39101
Marion County,Oregon,OR,284834,241642,187475,54167,43192,6191,37001,15.16392004,MU,41,41047
Marion County,South Carolina,SC,35466,14065,0,14065,21401,737,20664,60.34229967,MR,45,45067
Marion County,Tennessee,TN,27776,5749,0,5749,22027,238,21789,79.30227535,MR,47,47115
Marion County,Texas,TX,10941,0,0,0,10941,162,10779,100,CR,48,48315
Marion County,West Virginia,WV,56598,33127,0,33127,23471,330,23141,41.46966324,MU,54,54049
Mariposa County,California,CA,17130,0,0,0,17130,234,16896,100,CR,6,6043
Marlboro County,South Carolina,SC,28818,15214,0,15214,13604,446,13158,47.20660698,MU,45,45069
Marquette County,Michigan,MI,64634,37526,0,37526,27108,111,26997,41.94077421,MU,26,26103
Marquette County,Wisconsin,WI,15832,0,0,0,15832,808,15024,100,CR,55,55077
Marshall County,Alabama,AL,82231,35045,0,35045,47186,1885,45301,57.38225244,MR,1,1095
Marshall County,Illinois,IL,13180,2550,0,2550,10630,944,9686,80.65250379,MR,17,17123
Marshall County,Indiana,IN,45128,16635,0,16635,28493,1796,26697,63.13818472,MR,18,18099
Marshall County,Iowa,IA,39311,26122,0,26122,13189,1443,11746,33.55040574,MU,19,19127
Marshall County,Kansas,KS,10965,3057,0,3057,7908,1840,6068,72.12038304,MR,20,20117
Marshall County,Kentucky,KY,30125,4196,0,4196,25929,678,25251,86.07136929,MR,21,21157
Marshall County,Minnesota,MN,10155,0,0,0,10155,1378,8777,100,CR,27,27089
Marshall County,Mississippi,MS,34993,6719,0,6719,28274,1126,27148,80.79901695,MR,28,28093
Marshall County,Oklahoma,OK,13184,3832,0,3832,9352,457,8895,70.93446602,MR,40,40095
Marshall County,South Dakota,SD,4576,0,0,0,4576,682,3894,100,CR,46,46091
Marshall County,Tennessee,TN,26767,9755,0,9755,17012,1110,15902,63.55587104,MR,47,47117
Marshall County,West Virginia,WV,35519,17871,17871,0,17648,725,16923,49.6860835,MU,54,54051
Martin County,Florida,FL,126731,112771,107662,5109,13960,482,13478,11.01545794,MU,12,12085
Martin County,Indiana,IN,10369,2761,0,2761,7608,709,6899,73.3725528,MR,18,18101
Martin County,Kentucky,KY,12578,0,0,0,12578,68,12510,100,CR,21,21159
Martin County,Minnesota,MN,21802,10249,0,10249,11553,2235,9318,52.99055133,MR,27,27091
Martin County,North Carolina,NC,25593,5735,0,5735,19858,608,19250,77.59152893,MR,37,37117
Martin County,Texas,TX,4746,2492,0,2492,2254,332,1922,47.49262537,MU,48,48317
Martinsville city,Virginia,VA,15416,15416,0,15416,0,0,0,0,MU,51,51690
Mason County,Illinois,IL,16038,6524,0,6524,9514,587,8927,59.32161117,MR,17,17125
Mason County,Kentucky,KY,16800,8322,0,8322,8478,1073,7405,50.46428571,MR,21,21161
Mason County,Michigan,MI,28274,9798,0,9798,18476,791,17685,65.34625451,MR,26,26105
Mason County,Texas,TX,3738,0,0,0,3738,513,3225,100,CR,48,48319
Mason County,Washington,WA,49405,12507,0,12507,36898,454,36444,74.68474851,MR,53,53045
Mason County,West Virginia,WV,25957,7546,0,7546,18411,1204,17207,70.92884386,MR,54,54053
Massac County,Illinois,IL,15161,7557,0,7557,7604,624,6980,50.15500297,MR,17,17127
Matagorda County,Texas,TX,37957,25060,0,25060,12897,610,12287,33.97792239,MU,48,48321
Matanuska-Susitna Borough,Alaska,AK,59322,21352,0,21352,37970,456,37514,64.006608,MR,2,2170
Mathews County,Virginia,VA,9207,0,0,0,9207,86,9121,100,CR,51,51115
Maui County,Hawaii,HI,128094,112204,0,112204,15890,1091,14799,12.40495261,MU,15,15009
Maury County,Tennessee,TN,69498,39174,0,39174,30324,1710,28614,43.6329103,MU,47,47119
Maverick County,Texas,TX,47297,42212,0,42212,5085,190,4895,10.75121044,MU,48,48323
Mayes County,Oklahoma,OK,38369,8308,0,8308,30061,1919,28142,78.34710313,MR,40,40097
McClain County,Oklahoma,OK,27740,5123,0,5123,22617,1191,21426,81.53208363,MR,40,40087
McCone County,Montana,MT,1977,0,0,0,1977,594,1383,100,CR,30,30055
McCook County,South Dakota,SD,5832,0,0,0,5832,1067,4765,100,CR,46,46087
McCormick County,South Carolina,SC,9958,0,0,0,9958,228,9730,100,CR,45,45065
McCracken County,Kentucky,KY,65514,46790,0,46790,18724,664,18060,28.58015081,MU,21,21145
McCreary County,Kentucky,KY,17080,0,0,0,17080,117,16963,100,CR,21,21147
McCulloch County,Texas,TX,8205,5262,0,5262,2943,533,2410,35.86837294,MU,48,48307
McCurtain County,Oklahoma,OK,34402,10058,0,10058,24344,1652,22692,70.76332771,MR,40,40089
McDonald County,Missouri,MO,21681,0,0,0,21681,1459,20222,100,CR,29,29119
McDonough County,Illinois,IL,32913,22516,0,22516,10397,1530,8867,31.5893416,MU,17,17109
McDowell County,North Carolina,NC,42151,9819,0,9819,32332,410,31922,76.705179,MR,37,37111
McDowell County,West Virginia,WV,27329,3239,0,3239,24090,222,23868,88.14812104,MR,54,54047
McDuffie County,Georgia,GA,21231,8038,0,8038,13193,562,12631,62.14026659,MR,13,13189
McHenry County,Illinois,IL,260077,228772,188710,40062,31305,1699,29606,12.03681986,MU,17,17111
McHenry County,North Dakota,ND,5987,0,0,0,5987,1220,4767,100,CR,38,38049
McIntosh County,Georgia,GA,10847,2870,0,2870,7977,164,7813,73.54107126,MR,13,13191
McIntosh County,North Dakota,ND,3390,0,0,0,3390,699,2691,100,CR,38,38051
McIntosh County,Oklahoma,OK,19456,2537,0,2537,16919,1046,15873,86.96032072,MR,40,40091
McKean County,Pennsylvania,PA,45936,16796,0,16796,29140,333,28807,63.43608499,MR,42,42083
McKenzie County,North Dakota,ND,5737,0,0,0,5737,913,4824,100,CR,38,38053
McKinley County,New Mexico,NM,74798,29404,0,29404,45394,548,44846,60.68878847,MR,35,35031
McLean County,Illinois,IL,150433,115932,112582,3350,34501,2202,32299,22.93446252,MU,17,17113
McLean County,Kentucky,KY,9938,0,0,0,9938,820,9118,100,CR,21,21149
McLean County,North Dakota,ND,9311,0,0,0,9311,1194,8117,100,CR,38,38055
McLennan County,Texas,TX,213517,159896,152841,7055,53621,2435,51186,25.11322283,MU,48,48309
McLeod County,Minnesota,MN,34898,18537,0,18537,16361,2265,14096,46.88234283,MU,27,27085
McMinn County,Tennessee,TN,49015,20333,0,20333,28682,1258,27424,58.51678058,MR,47,47107
McMullen County,Texas,TX,851,0,0,0,851,153,698,100,CR,48,48311
McNairy County,Tennessee,TN,24653,3875,0,3875,20778,740,20038,84.28183183,MR,47,47109
McPherson County,Kansas,KS,29554,16920,0,16920,12634,2180,10454,42.74886648,MU,20,20113
McPherson County,Nebraska,NE,533,0,0,0,533,180,353,100,CR,31,31117
McPherson County,South Dakota,SD,2904,0,0,0,2904,677,2227,100,CR,46,46089
Meade County,Kansas,KS,4631,0,0,0,4631,502,4129,100,CR,20,20119
Meade County,Kentucky,KY,26349,4419,4419,0,21930,1309,20621,83.22896505,MR,21,21163
Meade County,South Dakota,SD,24253,13226,2370,10856,11027,1853,9174,45.46654022,MU,46,46093
Meagher County,Montana,MT,1932,0,0,0,1932,209,1723,100,CR,30,30059
Mecklenburg County,North Carolina,NC,695454,669285,669285,0,26169,272,25897,3.762865696,MU,37,37119
Mecklenburg County,Virginia,VA,32380,7008,0,7008,25372,1022,24350,78.3570105,MR,51,51117
Mecosta County,Michigan,MI,40553,11773,0,11773,28780,1138,27642,70.96885557,MR,26,26107
Medina County,Ohio,OH,151095,99800,59265,40535,51295,2145,49150,33.94884013,MU,39,39103
Medina County,Texas,TX,39304,17402,0,17402,21902,1853,20049,55.72460818,MR,48,48325
Meeker County,Minnesota,MN,22644,6456,0,6456,16188,2240,13948,71.4891362,MR,27,27093
Meigs County,Ohio,OH,23072,4864,0,4864,18208,517,17691,78.91816921,MR,39,39105
Meigs County,Tennessee,TN,11086,0,0,0,11086,393,10693,100,CR,47,47121
Mellette County,South Dakota,SD,2083,0,0,0,2083,287,1796,100,CR,46,46095
Menard County,Illinois,IL,12486,3079,0,3079,9407,506,8901,75.34038123,MR,17,17129
Menard County,Texas,TX,2360,0,0,0,2360,232,2128,100,CR,48,48327
Mendocino County,California,CA,86265,46616,0,46616,39649,1748,37901,45.96186171,MU,6,6045
Menifee County,Kentucky,KY,6556,0,0,0,6556,659,5897,100,CR,21,21165
Menominee County,Michigan,MI,25326,9235,0,9235,16091,551,15540,63.53549712,MR,26,26109
Menominee County,Wisconsin,WI,4562,0,0,0,4562,14,4548,100,CR,55,55078
Merced County,California,CA,210554,174915,118198,56717,35639,6497,29142,16.92629919,MU,6,6047
Mercer County,Illinois,IL,16957,3490,0,3490,13467,1396,12071,79.41852922,MR,17,17131
Mercer County,Kentucky,KY,20817,8436,0,8436,12381,1200,11181,59.47542874,MR,21,21167
Mercer County,Missouri,MO,3757,0,0,0,3757,547,3210,100,CR,29,29129
Mercer County,New Jersey,NJ,350761,336144,335247,897,14617,452,14165,4.167224977,MU,34,34021
Mercer County,North Dakota,ND,8644,2937,0,2937,5707,594,5113,66.02267469,MR,38,38057
Mercer County,Ohio,OH,40924,16323,0,16323,24601,3288,21313,60.11386961,MR,39,39107
Mercer County,Pennsylvania,PA,120293,62389,39849,22540,57904,1589,56315,48.13580175,MU,42,42085
Mercer County,West Virginia,WV,62980,33490,0,33490,29490,606,28884,46.82438869,MU,54,54055
Meriwether County,Georgia,GA,22534,3855,0,3855,18679,392,18287,82.89251797,MR,13,13199
Merrick County,Nebraska,NE,8204,3293,0,3293,4911,1014,3897,59.86104339,MR,31,31121
Merrimack County,New Hampshire,NH,136225,62852,7990,54862,73373,634,72739,53.86162599,MR,33,33013
Mesa County,Colorado,CO,116255,98577,92419,6158,17678,2023,15655,15.20622769,MU,8,8077
Metcalfe County,Kentucky,KY,10037,0,0,0,10037,1830,8207,100,CR,21,21169
Miami County,Indiana,IN,36082,18255,203,18052,17827,1623,16204,49.40690649,MU,18,18103
Miami County,Kansas,KS,28351,12629,0,12629,15722,1434,14288,55.45483404,MR,20,20121
Miami County,Ohio,OH,98868,67422,43393,24029,31446,2777,28669,31.80604442,MU,39,39109
Miami-Dade County,Florida,FL,2253362,2237388,2222569,14819,15974,1726,14248,0.708896307,MU,12,12086
Middlesex County,Connecticut,CT,155071,111621,102195,9426,43450,367,43083,28.01942336,MU,9,9007
Middlesex County,Massachusetts,MA,1465396,1417574,1409349,8225,47822,675,47147,3.263418216,MU,25,25017
Middlesex County,New Jersey,NJ,750162,742895,742895,0,7267,272,6995,0.968724089,MU,34,34023
Middlesex County,Virginia,VA,9932,0,0,0,9932,237,9695,100,CR,51,51119
Midland County,Michigan,MI,82874,45329,0,45329,37545,1097,36448,45.30371407,MU,26,26111
Midland County,Texas,TX,116009,101021,101021,0,14988,226,14762,12.91968727,MU,48,48329
Mifflin County,Pennsylvania,PA,46486,20536,0,20536,25950,1918,24032,55.82325862,MR,42,42087
Milam County,Texas,TX,24238,11805,0,11805,12433,1997,10436,51.29548643,MR,48,48331
Millard County,Utah,UT,12405,3146,0,3146,9259,683,8576,74.63925836,MR,49,49027
Mille Lacs County,Minnesota,MN,22330,3990,0,3990,18340,1290,17050,82.13166144,MR,27,27095
Miller County,Arkansas,AR,40443,23604,23604,0,16839,569,16270,41.63637712,MU,5,5091
Miller County,Georgia,GA,6383,0,0,0,6383,304,6079,100,CR,13,13201
Miller County,Missouri,MO,23564,5425,0,5425,18139,1530,16609,76.97759294,MR,29,29131
Mills County,Iowa,IA,14547,5575,0,5575,8972,866,8106,61.67594693,MR,19,19129
Mills County,Texas,TX,5151,0,0,0,5151,746,4405,100,CR,48,48333
Milwaukee County,Wisconsin,WI,940164,937091,937091,0,3073,80,2993,0.326857867,MU,55,55079
Miner County,South Dakota,SD,2884,0,0,0,2884,783,2101,100,CR,46,46097
Mineral County,Colorado,CO,831,0,0,0,831,29,802,100,CR,8,8079
Mineral County,Montana,MT,3884,0,0,0,3884,44,3840,100,CR,30,30061
Mineral County,Nevada,NV,5071,3492,0,3492,1579,5,1574,31.13784263,MU,32,32021
Mineral County,West Virginia,WV,27078,10038,0,10038,17040,305,16735,62.92931531,MR,54,54057
Mingo County,West Virginia,WV,28253,3138,0,3138,25115,92,25023,88.89321488,MR,54,54059
Minidoka County,Idaho,ID,20174,8893,0,8893,11281,1274,10007,55.91850897,MR,16,16067
Minnehaha County,South Dakota,SD,148281,125513,117530,7983,22768,2433,20335,15.35463073,MU,46,46099
Missaukee County,Michigan,MI,14478,0,0,0,14478,595,13883,100,CR,26,26113
Mississippi County,Arkansas,AR,51979,34041,0,34041,17938,425,17513,34.51009061,MU,5,5093
Mississippi County,Missouri,MO,13427,8398,0,8398,5029,243,4786,37.45438296,MU,29,29133
Missoula County,Montana,MT,95802,69502,69502,0,26300,821,25479,27.45245402,MU,30,30063
Mitchell County,Georgia,GA,23932,11194,0,11194,12738,545,12193,53.22580645,MR,13,13205
Mitchell County,Iowa,IA,10874,3380,0,3380,7494,1954,5540,68.91668199,MR,19,19131
Mitchell County,Kansas,KS,6932,3607,0,3607,3325,730,2595,47.96595499,MU,20,20123
Mitchell County,North Carolina,NC,15687,0,0,0,15687,398,15289,100,CR,37,37121
Mitchell County,Texas,TX,9698,6644,0,6644,3054,270,2784,31.49102908,MU,48,48335
Mobile County,Alabama,AL,399843,321090,317629,3461,78753,1502,77251,19.69598067,MU,1,1097
Modoc County,California,CA,9449,2890,0,2890,6559,731,5828,69.41475288,MR,6,6049
Moffat County,Colorado,CO,13184,9552,0,9552,3632,482,3150,27.54854369,MU,8,8081
Mohave County,Arizona,AZ,155032,117132,0,117132,37900,254,37646,24.44656587,MU,4,4015
Moniteau County,Missouri,MO,14827,7205,0,7205,7622,1637,5985,51.40621839,MR,29,29135
Monmouth County,New Jersey,NJ,615301,586982,586982,0,28319,917,27402,4.60246286,MU,34,34025
Mono County,California,CA,12853,5831,0,5831,7022,85,6937,54.63315957,MR,6,6051
Monona County,Iowa,IA,10020,2712,0,2712,7308,1301,6007,72.93413174,MR,19,19133
Monongalia County,West Virginia,WV,81866,55945,55945,0,25921,502,25419,31.66271712,MU,54,54061
Monroe County,Alabama,AL,24324,5238,0,5238,19086,453,18633,78.46571288,MR,1,1099
Monroe County,Arkansas,AR,10254,3839,0,3839,6415,176,6239,62.56095182,MR,5,5095
Monroe County,Florida,FL,79589,74268,0,74268,5321,0,5321,6.685597256,MU,12,12087
Monroe County,Georgia,GA,21757,5471,0,5471,16286,552,15734,74.85406995,MR,13,13207
Monroe County,Illinois,IL,27619,15354,8064,7290,12265,1083,11182,44.40783519,MU,17,17133
Monroe County,Indiana,IN,120563,92483,92483,0,28080,598,27482,23.29072767,MU,18,18105
Monroe County,Iowa,IA,8016,3513,0,3513,4503,987,3516,56.1751497,MR,19,19135
Monroe County,Kentucky,KY,11756,0,0,0,11756,1535,10221,100,CR,21,21171
Monroe County,Michigan,MI,145945,91855,82478,9377,54090,2659,51431,37.06190688,MU,26,26115
Monroe County,Mississippi,MS,38014,13278,0,13278,24736,580,24156,65.0707634,MR,28,28095
Monroe County,Missouri,MO,9311,0,0,0,9311,1558,7753,100,CR,29,29137
Monroe County,New York,NY,735343,684204,672307,11897,51139,768,50371,6.954441669,MU,36,36055
Monroe County,Ohio,OH,15180,337,0,337,14843,632,14211,97.77997365,MR,39,39111
Monroe County,Pennsylvania,PA,138687,69904,0,69904,68783,364,68419,49.59585253,MU,42,42089
Monroe County,Tennessee,TN,38961,8509,0,8509,30452,709,29743,78.16021149,MR,47,47123
Monroe County,West Virginia,WV,14583,1502,0,1502,13081,613,12468,89.70033601,MR,54,54063
Monroe County,Wisconsin,WI,40899,16962,0,16962,23937,3633,20304,58.52710335,MR,55,55081
Montague County,Texas,TX,19117,8858,0,8858,10259,955,9304,53.66427787,MR,48,48337
Montcalm County,Michigan,MI,61266,10527,0,10527,50739,1987,48752,82.8175497,MR,26,26117
Monterey County,California,CA,401762,358191,311791,46400,43571,1847,41724,10.84497787,MU,6,6053
Montezuma County,Colorado,CO,23830,8012,0,8012,15818,1069,14749,66.37851448,MR,8,8083
Montgomery County,Alabama,AL,223510,197017,197017,0,26493,947,25546,11.85316093,MU,1,1101
Montgomery County,Arkansas,AR,9245,0,0,0,9245,652,8593,100,CR,5,5097
Montgomery County,Georgia,GA,8270,141,0,141,8129,277,7852,98.29504232,MR,13,13209
Montgomery County,Illinois,IL,30652,16173,0,16173,14479,1543,12936,47.23672191,MU,17,17135
Montgomery County,Indiana,IN,37629,16715,0,16715,20914,1342,19572,55.57947328,MR,18,18107
Montgomery County,Iowa,IA,11771,6091,0,6091,5680,871,4809,48.25418401,MU,19,19137
Montgomery County,Kansas,KS,36252,20931,0,20931,15321,1382,13939,42.26249586,MU,20,20125
Montgomery County,Kentucky,KY,22554,10152,0,10152,12402,1074,11328,54.98802873,MR,21,21173
Montgomery County,Maryland,MD,873341,848458,843747,4711,24883,821,24062,2.849173461,MU,24,24031
Montgomery County,Mississippi,MS,12189,4791,0,4791,7398,396,7002,60.69406842,MR,28,28097
Montgomery County,Missouri,MO,12136,0,0,0,12136,1300,10836,100,CR,29,29139
Montgomery County,New York,NY,49708,29357,0,29357,20351,1229,19122,40.941096,MU,36,36057
Montgomery County,North Carolina,NC,26822,3342,0,3342,23480,445,23035,87.54007904,MR,37,37123
Montgomery County,Ohio,OH,559062,533203,522974,10229,25859,1642,24217,4.62542616,MU,39,39113
Montgomery County,Pennsylvania,PA,750097,723896,723896,0,26201,360,25841,3.493014903,MU,42,42091
Montgomery County,Tennessee,TN,134768,100263,100263,0,34505,931,33574,25.60325893,MU,47,47125
Montgomery County,Texas,TX,293768,188100,103308,84792,105668,1562,104106,35.96988099,MU,48,48339
Montgomery County,Virginia,VA,83629,57893,57221,672,25736,515,25221,30.7740138,MU,51,51121
Montmorency County,Michigan,MI,10315,0,0,0,10315,195,10120,100,CR,26,26119
Montour County,Pennsylvania,PA,18236,8325,0,8325,9911,601,9310,54.34854135,MR,42,42093
Montrose County,Colorado,CO,33432,15676,0,15676,17756,1617,16139,53.11079206,MR,8,8085
Moody County,South Dakota,SD,6595,0,0,0,6595,1311,5284,100,CR,46,46101
Moore County,North Carolina,NC,74769,30901,0,30901,43868,884,42984,58.6713745,MR,37,37125
Moore County,Tennessee,TN,5740,0,0,0,5740,629,5111,100,CR,47,47127
Moore County,Texas,TX,20121,16683,0,16683,3438,131,3307,17.08662591,MU,48,48341
Mora County,New Mexico,NM,5180,0,0,0,5180,296,4884,100,CR,35,35033
Morehouse Parish,Louisiana,LA,31021,16172,0,16172,14849,354,14495,47.86757358,MU,22,22067
Morgan County,Alabama,AL,111064,62608,52304,10304,48456,1330,47126,43.62889865,MU,1,1103
Morgan County,Colorado,CO,27171,18590,0,18590,8581,2120,6461,31.58146553,MU,8,8087
Morgan County,Georgia,GA,15457,3530,0,3530,11927,733,11194,77.16245067,MR,13,13211
Morgan County,Illinois,IL,36616,23604,0,23604,13012,1318,11694,35.53637754,MU,17,17137
Morgan County,Indiana,IN,66689,31131,19050,12081,35558,968,34590,53.31913809,MR,18,18109
Morgan County,Kentucky,KY,13948,2888,0,2888,11060,1466,9594,79.29452251,MR,21,21175
Morgan County,Missouri,MO,19309,0,0,0,19309,1430,17879,100,CR,29,29141
Morgan County,Ohio,OH,14897,2664,0,2664,12233,537,11696,82.11720481,MR,39,39115
Morgan County,Tennessee,TN,19757,3400,0,3400,16357,434,15923,82.79090955,MR,47,47129
Morgan County,Utah,UT,7129,0,0,0,7129,413,6716,100,CR,49,49029
Morgan County,West Virginia,WV,14943,0,0,0,14943,197,14746,100,CR,54,54065
Morrill County,Nebraska,NE,5440,0,0,0,5440,781,4659,100,CR,31,31123
Morris County,Kansas,KS,6104,0,0,0,6104,841,5263,100,CR,20,20127
Morris County,New Jersey,NJ,470212,432845,424862,7983,37367,300,37067,7.946840999,MU,34,34027
Morris County,Texas,TX,13048,2611,0,2611,10437,235,10202,79.98927039,MR,48,48343
Morrison County,Minnesota,MN,31712,9152,0,9152,22560,3709,18851,71.14026236,MR,27,27097
Morrow County,Ohio,OH,31628,3519,0,3519,28109,2016,26093,88.87378272,MR,39,39117
Morrow County,Oregon,OR,10995,5804,0,5804,5191,885,4306,47.21236926,MU,41,41049
Morton County,Kansas,KS,3496,0,0,0,3496,169,3327,100,CR,20,20129
Morton County,North Dakota,ND,25303,16560,16560,0,8743,1932,6811,34.55321503,MU,38,38059
Motley County,Texas,TX,1426,0,0,0,1426,180,1246,100,CR,48,48345
Moultrie County,Illinois,IL,14287,4485,0,4485,9802,1056,8746,68.6078253,MR,17,17139
Mountrail County,North Dakota,ND,6631,0,0,0,6631,1049,5582,100,CR,38,38061
Mower County,Minnesota,MN,38603,23620,0,23620,14983,2163,12820,38.81304562,MU,27,27099
Muhlenberg County,Kentucky,KY,31839,10201,0,10201,21638,614,21024,67.96067716,MR,21,21177
Multnomah County,Oregon,OR,660486,648829,648782,47,11657,798,10859,1.764912504,MU,41,41051
Murray County,Georgia,GA,36506,9644,0,9644,26862,552,26310,73.58242481,MR,13,13213
Murray County,Minnesota,MN,9165,0,0,0,9165,2113,7052,100,CR,27,27101
Murray County,Oklahoma,OK,12623,4685,0,4685,7938,506,7432,62.88520954,MR,40,40099
Muscatine County,Iowa,IA,41722,29543,0,29543,12179,1816,10363,29.19083457,MU,19,19139
Muscogee County,Georgia,GA,186291,181567,181567,0,4724,56,4668,2.535817619,MU,13,13215
Muskegon County,Michigan,MI,170200,125735,118174,7561,44465,972,43493,26.12514689,MU,26,26121
Muskingum County,Ohio,OH,84585,45474,0,45474,39111,1572,37539,46.2386948,MU,39,39119
Muskogee County,Oklahoma,OK,69451,42148,0,42148,27303,1560,25743,39.31260889,MU,40,40101
Musselshell County,Montana,MT,4497,0,0,0,4497,370,4127,100,CR,30,30065
Nacogdoches County,Texas,TX,59203,31017,0,31017,28186,1421,26765,47.60907386,MU,48,48347
Nance County,Nebraska,NE,4038,0,0,0,4038,709,3329,100,CR,31,31125
Nantucket County,Massachusetts,MA,9520,7571,0,7571,1949,28,1921,20.47268908,MU,25,25019
Napa County,California,CA,124279,104554,89708,14846,19725,2126,17599,15.87154708,MU,6,6055
Nash County,North Carolina,NC,87420,45037,43648,1389,42383,1280,41103,48.48204072,MU,37,37127
Nassau County,Florida,FL,57663,28562,0,28562,29101,559,28542,50.46737076,MR,12,12089
Nassau County,New York,NY,1334544,1332382,1332382,0,2162,9,2153,0.162002901,MU,36,36059
Natchitoches Parish,Louisiana,LA,39080,19258,0,19258,19822,812,19010,50.72159672,MR,22,22069
Natrona County,Wyoming,WY,66533,57589,57589,0,8944,376,8568,13.44295312,MU,56,56025
Navajo County,Arizona,AZ,97470,40937,0,40937,56533,273,56260,58.00041038,MR,4,4017
Navarro County,Texas,TX,45124,23166,0,23166,21958,1240,20718,48.66146618,MU,48,48349
Nelson County,Kentucky,KY,37477,14033,0,14033,23444,1914,21530,62.55570083,MR,21,21179
Nelson County,North Dakota,ND,3715,0,0,0,3715,504,3211,100,CR,38,38063
Nelson County,Virginia,VA,14445,0,0,0,14445,511,13934,100,CR,51,51125
Nemaha County,Kansas,KS,10717,0,0,0,10717,2070,8647,100,CR,20,20131
Nemaha County,Nebraska,NE,7576,3517,0,3517,4059,778,3281,53.57708553,MR,31,31127
Neosho County,Kansas,KS,16997,9332,0,9332,7665,1022,6643,45.09619345,MU,20,20133
Neshoba County,Mississippi,MS,28684,6603,0,6603,22081,1229,20852,76.98019802,MR,28,28099
Ness County,Kansas,KS,3454,0,0,0,3454,499,2955,100,CR,20,20135
Nevada County,Arkansas,AR,9955,3029,0,3029,6926,370,6556,69.57307885,MR,5,5099
Nevada County,California,CA,92033,52211,0,52211,39822,398,39424,43.26926211,MU,6,6057
New Castle County,Delaware,DE,500265,472455,464625,7830,27810,783,27027,5.559053702,MU,10,10003
New Hanover County,North Carolina,NC,160307,152930,152930,0,7377,70,7307,4.601795305,MU,37,37129
New Haven County,Connecticut,CT,824008,789108,789108,0,34900,163,34737,4.235395773,MU,9,9009
New Kent County,Virginia,VA,13462,0,0,0,13462,155,13307,100,CR,51,51127
New London County,Connecticut,CT,259088,187688,172827,14861,71400,1036,70364,27.55820416,MU,9,9011
New Madrid County,Missouri,MO,19760,7705,0,7705,12055,338,11717,61.00708502,MR,29,29143
New York County,New York,NY,1537195,1537195,1537195,0,0,0,0,0,MU,36,36061
Newaygo County,Michigan,MI,47874,8222,0,8222,39652,1459,38193,82.82575093,MR,26,26123
Newberry County,South Carolina,SC,36108,11962,0,11962,24146,535,23611,66.8716074,MR,45,45071
Newport County,Rhode Island,RI,85433,76024,76024,0,9409,242,9167,11.01330867,MU,44,44005
Newport News city,Virginia,VA,180150,180101,180101,0,49,0,49,0.027199556,MU,51,51700
Newton County,Arkansas,AR,8608,0,0,0,8608,411,8197,100,CR,5,5101
Newton County,Georgia,GA,62001,34531,34531,0,27470,403,27067,44.305737,MU,13,13217
Newton County,Indiana,IN,14566,384,0,384,14182,576,13606,97.36372374,MR,18,18111
Newton County,Mississippi,MS,21838,3331,0,3331,18507,555,17952,84.74677168,MR,28,28101
Newton County,Missouri,MO,52636,18555,8100,10455,34081,2091,31990,64.74846113,MR,29,29145
Newton County,Texas,TX,15072,0,0,0,15072,402,14670,100,CR,48,48351
Nez Perce County,Idaho,ID,37410,31087,31087,0,6323,350,5973,16.90189789,MU,16,16069
Niagara County,New York,NY,219846,164911,125184,39727,54935,1283,53652,24.98794611,MU,36,36063
Nicholas County,Kentucky,KY,6813,0,0,0,6813,827,5986,100,CR,21,21181
Nicholas County,West Virginia,WV,26562,5832,0,5832,20730,186,20544,78.043822,MR,54,54067
Nicollet County,Minnesota,MN,29771,21440,0,21440,8331,1630,6701,27.98360821,MU,27,27103
Niobrara County,Wyoming,WY,2407,0,0,0,2407,386,2021,100,CR,56,56027
Noble County,Indiana,IN,46275,15544,0,15544,30731,2150,28581,66.40950837,MR,18,18113
Noble County,Ohio,OH,14058,4873,0,4873,9185,968,8217,65.33646322,MR,39,39121
Noble County,Oklahoma,OK,11411,5131,0,5131,6280,936,5344,55.03461572,MR,40,40103
Nobles County,Minnesota,MN,20832,11154,0,11154,9678,2412,7266,46.45737327,MU,27,27105
Nodaway County,Missouri,MO,21912,11600,0,11600,10312,2275,8037,47.06097116,MU,29,29147
Nolan County,Texas,TX,15802,11225,0,11225,4577,265,4312,28.96468801,MU,48,48353
Nome Census Area,Alaska,AK,9196,2896,0,2896,6300,7,6293,68.50804698,MR,2,2180
Norfolk city,Virginia,VA,234403,234403,234403,0,0,0,0,0,MU,51,51710
Norfolk County,Massachusetts,MA,650308,628900,628900,0,21408,128,21280,3.29197857,MU,25,25021
Norman County,Minnesota,MN,7442,0,0,0,7442,953,6489,100,CR,27,27107
North Slope Borough,Alaska,AK,7385,4318,0,4318,3067,9,3058,41.53012864,MU,2,2185
Northampton County,North Carolina,NC,22086,2164,0,2164,19922,730,19192,90.20193788,MR,37,37131
Northampton County,Pennsylvania,PA,267066,226104,226028,76,40962,584,40378,15.33778167,MU,42,42095
Northampton County,Virginia,VA,13093,0,0,0,13093,346,12747,100,CR,51,51131
Northumberland County,Pennsylvania,PA,94556,59593,0,59593,34963,1517,33446,36.97597191,MU,42,42097
Northumberland County,Virginia,VA,12259,0,0,0,12259,606,11653,100,CR,51,51133
Northwest Arctic Borough,Alaska,AK,7208,3067,0,3067,4141,0,4141,57.45005549,MR,2,2188
Norton city,Virginia,VA,3904,3571,0,3571,333,30,303,8.529713115,MU,51,51720
Norton County,Kansas,KS,5953,3750,0,3750,2203,302,1901,37.00655132,MU,20,20137
Nottoway County,Virginia,VA,15725,7267,0,7267,8458,417,8041,53.78696343,MR,51,51135
Nowata County,Oklahoma,OK,10569,4679,0,4679,5890,977,4913,55.72901883,MR,40,40105
Noxubee County,Mississippi,MS,12548,3021,0,3021,9527,977,8550,75.92445011,MR,28,28103
Nuckolls County,Nebraska,NE,5057,0,0,0,5057,760,4297,100,CR,31,31129
Nueces County,Texas,TX,313645,296122,276345,19777,17523,703,16820,5.586889636,MU,48,48355
Nye County,Nevada,NV,32485,14616,0,14616,17869,113,17756,55.00692627,MR,32,32023
Oakland County,Michigan,MI,1194156,1133008,1123071,9937,61148,816,60332,5.120604008,MU,26,26125
Obion County,Tennessee,TN,32450,13249,0,13249,19201,1023,18178,59.17103236,MR,47,47131
O'Brien County,Iowa,IA,15102,4559,0,4559,10543,1800,8743,69.81194544,MR,19,19141
Ocean County,New Jersey,NJ,510916,496071,492506,3565,14845,161,14684,2.90556569,MU,34,34029
Oceana County,Michigan,MI,26873,0,0,0,26873,1102,25771,100,CR,26,26127
Ochiltree County,Texas,TX,9006,7693,0,7693,1313,334,979,14.57916944,MU,48,48357
Oconee County,Georgia,GA,26225,13035,13035,0,13190,530,12660,50.29551954,MR,13,13219
Oconee County,South Carolina,SC,66215,19490,0,19490,46725,509,46216,70.56558182,MR,45,45073
Oconto County,Wisconsin,WI,35634,7008,0,7008,28626,2019,26607,80.33338946,MR,55,55083
Ogemaw County,Michigan,MI,21645,0,0,0,21645,405,21240,100,CR,26,26129
Ogle County,Illinois,IL,51032,26424,0,26424,24608,1949,22659,48.22072425,MU,17,17141
Oglethorpe County,Georgia,GA,12635,15,15,0,12620,906,11714,99.88128215,MR,13,13221
Ohio County,Indiana,IN,5623,0,0,0,5623,365,5258,100,CR,18,18115
Ohio County,Kentucky,KY,22916,5749,0,5749,17167,1144,16023,74.91272473,MR,21,21183
Ohio County,West Virginia,WV,47427,37742,37742,0,9685,184,9501,20.42085732,MU,54,54069
Okaloosa County,Florida,FL,170498,150088,128086,22002,20410,414,19996,11.97081491,MU,12,12091
Okanogan County,Washington,WA,39564,8476,0,8476,31088,1927,29161,78.57648367,MR,53,53047
Okeechobee County,Florida,FL,35910,20644,0,20644,15266,416,14850,42.51183514,MU,12,12093
Okfuskee County,Oklahoma,OK,11814,2947,0,2947,8867,834,8033,75.05501947,MR,40,40107
Oklahoma County,Oklahoma,OK,660448,618428,614213,4215,42020,942,41078,6.362347982,MU,40,40109
Okmulgee County,Oklahoma,OK,39685,20314,0,20314,19371,1303,18068,48.81189366,MU,40,40111
Oktibbeha County,Mississippi,MS,42902,26073,0,26073,16829,516,16313,39.22660948,MU,28,28105
Oldham County,Kentucky,KY,46178,30121,20261,9860,16057,269,15788,34.77196934,MU,21,21185
Oldham County,Texas,TX,2185,0,0,0,2185,104,2081,100,CR,48,48359
Oliver County,North Dakota,ND,2065,0,0,0,2065,615,1450,100,CR,38,38065
Olmsted County,Minnesota,MN,124277,100172,91317,8855,24105,2765,21340,19.39618755,MU,27,27109
Oneida County,Idaho,ID,4125,0,0,0,4125,519,3606,100,CR,16,16071
Oneida County,New York,NY,235469,152137,112269,39868,83332,1731,81601,35.38979653,MU,36,36065
Oneida County,Wisconsin,WI,36776,9639,0,9639,27137,171,26966,73.78997172,MR,55,55085
Onondaga County,New York,NY,458336,396960,393440,3520,61376,1511,59865,13.39104936,MU,36,36067
Onslow County,North Carolina,NC,150355,107098,95524,11574,43257,621,42636,28.76991121,MU,37,37133
Ontario County,New York,NY,100224,49288,12588,36700,50936,1508,49428,50.82215837,MR,36,36069
Ontonagon County,Michigan,MI,7818,0,0,0,7818,236,7582,100,CR,26,26131
Orange County,California,CA,2846289,2840836,2840836,0,5453,35,5418,0.191582794,MU,6,6059
Orange County,Florida,FL,896344,865854,865854,0,30490,359,30131,3.401595816,MU,12,12095
Orange County,Indiana,IN,19306,6224,0,6224,13082,906,12176,67.76131773,MR,18,18117
Orange County,New York,NY,341367,258580,205970,52610,82787,1301,81486,24.2516119,MU,36,36071
Orange County,North Carolina,NC,118227,80445,80445,0,37782,984,36798,31.95716714,MU,37,37135
Orange County,Texas,TX,84966,55099,16713,38386,29867,193,29674,35.15170774,MU,48,48361
Orange County,Vermont,VT,28226,655,0,655,27571,1136,26435,97.67944448,MR,50,50017
Orange County,Virginia,VA,25881,8315,0,8315,17566,550,17016,67.87218423,MR,51,51137
Orangeburg County,South Carolina,SC,91582,30300,0,30300,61282,1912,59370,66.91489594,MR,45,45075
Oregon County,Missouri,MO,10344,2077,0,2077,8267,979,7288,79.92072699,MR,29,29149
Orleans County,New York,NY,44171,19028,0,19028,25143,945,24198,56.92196237,MR,36,36073
Orleans County,Vermont,VT,26277,4771,0,4771,21506,1031,20475,81.84343723,MR,50,50019
Orleans Parish,Louisiana,LA,484674,481424,481424,0,3250,0,3250,0.670553816,MU,22,22071
Osage County,Kansas,KS,16712,0,0,0,16712,1388,15324,100,CR,20,20139
Osage County,Missouri,MO,13062,0,0,0,13062,1780,11282,100,CR,29,29151
Osage County,Oklahoma,OK,44437,18250,5641,12609,26187,1209,24978,58.93062088,MR,40,40113
Osborne County,Kansas,KS,4452,0,0,0,4452,719,3733,100,CR,20,20141
Osceola County,Florida,FL,172493,132113,123871,8242,40380,483,39897,23.40964561,MU,12,12097
Osceola County,Iowa,IA,7003,2745,0,2745,4258,1192,3066,60.80251321,MR,19,19143
Osceola County,Michigan,MI,23197,2581,0,2581,20616,775,19841,88.87356124,MR,26,26133
Oscoda County,Michigan,MI,9418,0,0,0,9418,267,9151,100,CR,26,26135
Oswego County,New York,NY,122377,43389,6240,37149,78988,1151,77837,64.54480826,MR,36,36075
Otero County,Colorado,CO,20311,12656,0,12656,7655,953,6702,37.68893703,MU,8,8089
Otero County,New Mexico,NM,62298,43703,0,43703,18595,530,18065,29.84847026,MU,35,35035
Otoe County,Nebraska,NE,15396,7059,0,7059,8337,1413,6924,54.15042868,MR,31,31131
Otsego County,Michigan,MI,23301,7778,0,7778,15523,299,15224,66.61945839,MR,26,26137
Otsego County,New York,NY,61676,16039,0,16039,45637,1756,43881,73.99474674,MR,36,36077
Ottawa County,Kansas,KS,6163,0,0,0,6163,758,5405,100,CR,20,20143
Ottawa County,Michigan,MI,238314,181633,178014,3619,56681,2679,54002,23.78416711,MU,26,26139
Ottawa County,Ohio,OH,40985,19265,2009,17256,21720,1171,20549,52.99499817,MR,39,39123
Ottawa County,Oklahoma,OK,33194,16799,0,16799,16395,1255,15140,49.39145629,MU,40,40115
Otter Tail County,Minnesota,MN,57159,13060,0,13060,44099,4942,39157,77.15145471,MR,27,27111
Ouachita County,Arkansas,AR,28790,12340,0,12340,16450,255,16195,57.1378951,MR,5,5103
Ouachita Parish,Louisiana,LA,147250,113947,113947,0,33303,503,32800,22.61663837,MU,22,22073
Ouray County,Colorado,CO,3742,0,0,0,3742,138,3604,100,CR,8,8091
Outagamie County,Wisconsin,WI,160971,119345,114777,4568,41626,2603,39023,25.85931627,MU,55,55087
Overton County,Tennessee,TN,20118,3149,0,3149,16969,1002,15967,84.34735063,MR,47,47133
Owen County,Indiana,IN,21786,0,0,0,21786,1014,20772,100,CR,18,18119
Owen County,Kentucky,KY,10547,0,0,0,10547,1270,9277,100,CR,21,21187
Owsley County,Kentucky,KY,4858,0,0,0,4858,424,4434,100,CR,21,21189
Owyhee County,Idaho,ID,10644,2744,0,2744,7900,1108,6792,74.22021796,MR,16,16073
Oxford County,Maine,ME,54755,9424,0,9424,45331,910,44421,82.78878641,MR,23,23017
Ozark County,Missouri,MO,9542,0,0,0,9542,878,8664,100,CR,29,29153
Ozaukee County,Wisconsin,WI,82317,61567,51022,10545,20750,884,19866,25.20742981,MU,55,55089
Pacific County,Washington,WA,20984,10258,0,10258,10726,290,10436,51.11513534,MR,53,53049
Page County,Iowa,IA,16976,11198,0,11198,5778,1301,4477,34.03628652,MU,19,19145
Page County,Virginia,VA,23177,4823,0,4823,18354,969,17385,79.19057686,MR,51,51139
Palm Beach County,Florida,FL,1131184,1112352,1070518,41834,18832,731,18101,1.664804311,MU,12,12099
Palo Alto County,Iowa,IA,10147,3600,0,3600,6547,1238,5309,64.52153346,MR,19,19147
Palo Pinto County,Texas,TX,27026,14172,0,14172,12854,526,12328,47.56160734,MU,48,48363
Pamlico County,North Carolina,NC,12934,0,0,0,12934,106,12828,100,CR,37,37137
Panola County,Mississippi,MS,34274,9425,0,9425,24849,1180,23669,72.50102118,MR,28,28107
Panola County,Texas,TX,22756,5764,0,5764,16992,994,15998,74.67041659,MR,48,48365
Park County,Colorado,CO,14523,0,0,0,14523,302,14221,100,CR,8,8093
Park County,Montana,MT,15694,8312,0,8312,7382,752,6630,47.03708424,MU,30,30067
Park County,Wyoming,WY,25786,14495,0,14495,11291,1352,9939,43.78732646,MU,56,56029
Parke County,Indiana,IN,17241,3003,0,3003,14238,1000,13238,82.58221681,MR,18,18121
Parker County,Texas,TX,88495,30443,6625,23818,58052,2660,55392,65.59918639,MR,48,48367
Parmer County,Texas,TX,10016,3905,0,3905,6111,806,5305,61.01238019,MR,48,48369
Pasco County,Florida,FL,344765,293654,288709,4945,51111,979,50132,14.82488072,MU,12,12101
Pasquotank County,North Carolina,NC,34897,19162,0,19162,15735,302,15433,45.0898358,MU,37,37139
Passaic County,New Jersey,NJ,489049,477134,471768,5366,11915,0,11915,2.436361183,MU,34,34031
Patrick County,Virginia,VA,19407,0,0,0,19407,805,18602,100,CR,51,51141
Paulding County,Georgia,GA,81678,49050,49050,0,32628,363,32265,39.94710938,MU,13,13223
Paulding County,Ohio,OH,20293,3570,0,3570,16723,1075,15648,82.4077268,MR,39,39125
Pawnee County,Kansas,KS,7233,4874,0,4874,2359,474,1885,32.61440619,MU,20,20145
Pawnee County,Nebraska,NE,3087,0,0,0,3087,701,2386,100,CR,31,31133
Pawnee County,Oklahoma,OK,16612,3176,0,3176,13436,837,12599,80.88129063,MR,40,40117
Payette County,Idaho,ID,20578,11556,0,11556,9022,1473,7549,43.84293906,MU,16,16075
Payne County,Oklahoma,OK,68190,46323,0,46323,21867,1576,20291,32.06775187,MU,40,40119
Peach County,Georgia,GA,23668,15046,4886,10160,8622,251,8371,36.42893358,MU,13,13225
Pearl River County,Mississippi,MS,48621,14754,0,14754,33867,586,33281,69.65508731,MR,28,28109
Pecos County,Texas,TX,16809,9908,0,9908,6901,217,6684,41.055387,MU,48,48371
Pembina County,North Dakota,ND,8585,0,0,0,8585,557,8028,100,CR,38,38067
Pemiscot County,Missouri,MO,20047,13029,0,13029,7018,332,6686,35.00773183,MU,29,29155
Pend Oreille County,Washington,WA,11732,0,0,0,11732,263,11469,100,CR,53,53051
Pender County,North Carolina,NC,41082,3243,0,3243,37839,612,37227,92.10603184,MR,37,37141
Pendleton County,Kentucky,KY,14390,0,0,0,14390,1224,13166,100,CR,21,21191
Pendleton County,West Virginia,WV,8196,0,0,0,8196,773,7423,100,CR,54,54071
Pennington County,Minnesota,MN,13584,9164,0,9164,4420,633,3787,32.53828033,MU,27,27113
Pennington County,South Dakota,SD,88565,67898,64445,3453,20667,1343,19324,23.33540338,MU,46,46103
Penobscot County,Maine,ME,144919,63972,59140,4832,80947,1156,79791,55.85671996,MR,23,23019
Peoria County,Illinois,IL,183433,156168,145928,10240,27265,1716,25549,14.86373771,MU,17,17143
Pepin County,Wisconsin,WI,7213,0,0,0,7213,971,6242,100,CR,55,55091
Perkins County,Nebraska,NE,3200,0,0,0,3200,558,2642,100,CR,31,31135
Perkins County,South Dakota,SD,3363,0,0,0,3363,888,2475,100,CR,46,46105
Perquimans County,North Carolina,NC,11368,0,0,0,11368,402,10966,100,CR,37,37143
Perry County,Alabama,AL,11861,0,0,0,11861,465,11396,100,CR,1,1105
Perry County,Arkansas,AR,10209,0,0,0,10209,380,9829,100,CR,5,5105
Perry County,Illinois,IL,23094,9994,0,9994,13100,1207,11893,56.7246904,MR,17,17145
Perry County,Indiana,IN,18899,8985,0,8985,9914,551,9363,52.457802,MR,18,18123
Perry County,Kentucky,KY,29390,6431,0,6431,22959,343,22616,78.11840762,MR,21,21193
Perry County,Mississippi,MS,12138,0,0,0,12138,470,11668,100,CR,28,28111
Perry County,Missouri,MO,18132,7873,0,7873,10259,1213,9046,56.57952791,MR,29,29157
Perry County,Ohio,OH,34078,9072,0,9072,25006,925,24081,73.37871941,MR,39,39127
Perry County,Pennsylvania,PA,43602,5956,3012,2944,37646,1395,36251,86.34007614,MR,42,42099
Perry County,Tennessee,TN,7631,0,0,0,7631,172,7459,100,CR,47,47135
Pershing County,Nevada,NV,6693,0,0,0,6693,354,6339,100,CR,32,32027
Person County,North Carolina,NC,35623,9492,0,9492,26131,1244,24887,73.35429357,MR,37,37145
Petersburg city,Virginia,VA,33740,32878,32878,0,862,0,862,2.554831061,MU,51,51730
Petroleum County,Montana,MT,493,0,0,0,493,147,346,100,CR,30,30069
Pettis County,Missouri,MO,39403,24501,0,24501,14902,1978,12924,37.81945537,MU,29,29159
Phelps County,Missouri,MO,39825,20827,0,20827,18998,948,18050,47.7037037,MU,29,29161
Phelps County,Nebraska,NE,9747,5674,0,5674,4073,668,3405,41.78721658,MU,31,31137
Philadelphia County,Pennsylvania,PA,1517550,1517550,1517550,0,0,0,0,0,MU,42,42101
Phillips County,Arkansas,AR,26445,13870,0,13870,12575,224,12351,47.55152203,MU,5,5107
Phillips County,Colorado,CO,4480,0,0,0,4480,594,3886,100,CR,8,8095
Phillips County,Kansas,KS,6001,2668,0,2668,3333,667,2666,55.54074321,MR,20,20147
Phillips County,Montana,MT,4601,0,0,0,4601,633,3968,100,CR,30,30071
Piatt County,Illinois,IL,16365,5098,0,5098,11267,620,10647,68.84815154,MR,17,17147
Pickaway County,Ohio,OH,52727,28964,0,28964,23763,1482,22281,45.06799173,MU,39,39129
Pickens County,Alabama,AL,20949,0,0,0,20949,793,20156,100,CR,1,1107
Pickens County,Georgia,GA,22983,5000,0,5000,17983,352,17631,78.24478963,MR,13,13227
Pickens County,South Carolina,SC,110757,64579,40909,23670,46178,712,45466,41.69307583,MU,45,45077
Pickett County,Tennessee,TN,4945,0,0,0,4945,531,4414,100,CR,47,47137
Pierce County,Georgia,GA,15636,3511,0,3511,12125,656,11469,77.54540803,MR,13,13229
Pierce County,Nebraska,NE,7857,0,0,0,7857,1480,6377,100,CR,31,31139
Pierce County,North Dakota,ND,4675,2894,0,2894,1781,847,934,38.09625668,MU,38,38069
Pierce County,Washington,WA,700820,645781,645579,202,55039,1046,53993,7.853514454,MU,53,53053
Pierce County,Wisconsin,WI,36804,14166,0,14166,22638,2555,20083,61.50961852,MR,55,55093
Pike County,Alabama,AL,29605,11776,0,11776,17829,647,17182,60.22293531,MR,1,1109
Pike County,Arkansas,AR,11303,0,0,0,11303,491,10812,100,CR,5,5109
Pike County,Georgia,GA,13688,0,0,0,13688,419,13269,100,CR,13,13231
Pike County,Illinois,IL,17384,4126,0,4126,13258,1547,11711,76.26553152,MR,17,17149
Pike County,Indiana,IN,12837,2616,0,2616,10221,719,9502,79.62140687,MR,18,18125
Pike County,Kentucky,KY,68736,6346,0,6346,62390,180,62210,90.76757449,MR,21,21195
Pike County,Mississippi,MS,38940,18518,0,18518,20422,910,19512,52.44478685,MR,28,28113
Pike County,Missouri,MO,18351,9261,0,9261,9090,1544,7546,49.53408534,MU,29,29163
Pike County,Ohio,OH,27695,5428,0,5428,22267,593,21674,80.40079437,MR,39,39131
Pike County,Pennsylvania,PA,46302,4895,0,4895,41407,81,41326,89.42810246,MR,42,42103
Pima County,Arizona,AZ,843746,772162,719888,52274,71584,1214,70370,8.48406985,MU,4,4019
Pinal County,Arizona,AZ,179727,116082,39681,76401,63645,1184,62461,35.4120416,MU,4,4021
Pine County,Minnesota,MN,26530,3018,0,3018,23512,1827,21685,88.62419902,MR,27,27115
Pinellas County,Florida,FL,921482,920518,920518,0,964,19,945,0.104614089,MU,12,12103
Pipestone County,Minnesota,MN,9895,4149,0,4149,5746,1633,4113,58.06973219,MR,27,27117
Piscataquis County,Maine,ME,17235,0,0,0,17235,238,16997,100,CR,23,23021
Pitkin County,Colorado,CO,14872,7023,0,7023,7849,62,7787,52.77703066,MR,8,8097
Pitt County,North Carolina,NC,133798,87493,83646,3847,46305,931,45374,34.60814063,MU,37,37147
Pittsburg County,Oklahoma,OK,43953,22144,0,22144,21809,1403,20406,49.61891111,MU,40,40121
Pittsylvania County,Virginia,VA,61745,6411,5249,1162,55334,2249,53085,89.61697303,MR,51,51143
Piute County,Utah,UT,1435,0,0,0,1435,67,1368,100,CR,49,49031
Placer County,California,CA,248399,195814,173767,22047,52585,1263,51322,21.16956993,MU,6,6061
Plaquemines Parish,Louisiana,LA,26757,18327,8526,9801,8430,207,8223,31.50577419,MU,22,22075
Platte County,Missouri,MO,73781,59013,54431,4582,14768,1257,13511,20.01599328,MU,29,29165
Platte County,Nebraska,NE,31662,21046,0,21046,10616,2278,8338,33.52915166,MU,31,31141
Platte County,Wyoming,WY,8807,3534,0,3534,5273,612,4661,59.87282843,MR,56,56031
Pleasants County,West Virginia,WV,7514,3199,0,3199,4315,133,4182,57.42613788,MR,54,54073
Plumas County,California,CA,20824,2668,0,2668,18156,174,17982,87.18786016,MR,6,6063
Plymouth County,Iowa,IA,24849,9018,20,8998,15831,3208,12623,63.70880116,MR,19,19149
Plymouth County,Massachusetts,MA,472822,425472,425472,0,47350,343,47007,10.01433943,MU,25,25023
Pocahontas County,Iowa,IA,8662,0,0,0,8662,1336,7326,100,CR,19,19151
Pocahontas County,West Virginia,WV,9131,0,0,0,9131,426,8705,100,CR,54,54075
Poinsett County,Arkansas,AR,25614,9413,0,9413,16201,391,15810,63.2505661,MR,5,5111
Pointe Coupee Parish,Louisiana,LA,22763,9416,0,9416,13347,643,12704,58.63462637,MR,22,22077
Polk County,Arkansas,AR,20229,5189,0,5189,15040,1105,13935,74.3487073,MR,5,5113
Polk County,Florida,FL,483924,386213,354422,31791,97711,1359,96352,20.19139369,MU,12,12105
Polk County,Georgia,GA,38127,18424,0,18424,19703,475,19228,51.67728906,MR,13,13233
Polk County,Iowa,IA,374601,352865,352559,306,21736,1677,20059,5.802440463,MU,19,19153
Polk County,Minnesota,MN,31369,15385,7350,8035,15984,2163,13821,50.95476426,MR,27,27119
Polk County,Missouri,MO,26992,8430,0,8430,18562,2137,16425,68.76852401,MR,29,29167
Polk County,Nebraska,NE,5639,0,0,0,5639,963,4676,100,CR,31,31143
Polk County,North Carolina,NC,18324,1709,0,1709,16615,253,16362,90.67343375,MR,37,37149
Polk County,Oregon,OR,62380,47642,20010,27632,14738,2542,12196,23.62616223,MU,41,41053
Polk County,Tennessee,TN,16050,0,0,0,16050,433,15617,100,CR,47,47139
Polk County,Texas,TX,41133,8231,0,8231,32902,573,32329,79.98930299,MR,48,48373
Polk County,Wisconsin,WI,41319,2829,0,2829,38490,2298,36192,93.15327089,MR,55,55095
Pondera County,Montana,MT,6424,2784,0,2784,3640,850,2790,56.66251557,MR,30,30073
Pontotoc County,Mississippi,MS,26726,4281,0,4281,22445,717,21728,83.98189029,MR,28,28115
Pontotoc County,Oklahoma,OK,35143,16411,0,16411,18732,1205,17527,53.30222235,MR,40,40123
Pope County,Arkansas,AR,54469,22829,0,22829,31640,1262,30378,58.0880868,MR,5,5115
Pope County,Illinois,IL,4413,0,0,0,4413,285,4128,100,CR,17,17151
Pope County,Minnesota,MN,11236,0,0,0,11236,1776,9460,100,CR,27,27121
Poquoson city,Virginia,VA,11566,11077,11077,0,489,0,489,4.22790939,MU,51,51735
Portage County,Ohio,OH,152061,89069,86073,2996,62992,1536,61456,41.42548056,MU,39,39133
Portage County,Wisconsin,WI,67182,41348,0,41348,25834,1646,24188,38.45375249,MU,55,55097
Porter County,Indiana,IN,146798,114735,103835,10900,32063,863,31200,21.84157822,MU,18,18127
Portsmouth city,Virginia,VA,100565,100565,100565,0,0,0,0,0,MU,51,51740
Posey County,Indiana,IN,27061,8375,499,7876,18686,1480,17206,69.05140239,MR,18,18129
Pottawatomie County,Kansas,KS,18209,4238,0,4238,13971,1464,12507,76.72579494,MR,20,20149
Pottawatomie County,Oklahoma,OK,65521,31799,0,31799,33722,1707,32015,51.46746845,MR,40,40125
Pottawattamie County,Iowa,IA,87704,63903,63903,0,23801,2682,21119,27.13787285,MU,19,19155
Potter County,Pennsylvania,PA,18080,0,0,0,18080,427,17653,100,CR,42,42105
Potter County,South Dakota,SD,2693,0,0,0,2693,331,2362,100,CR,46,46107
Potter County,Texas,TX,113546,103352,103352,0,10194,240,9954,8.977859194,MU,48,48375
Powder River County,Montana,MT,1858,0,0,0,1858,454,1404,100,CR,30,30075
Powell County,Kentucky,KY,13237,3133,0,3133,10104,316,9788,76.33149505,MR,21,21197
Powell County,Montana,MT,7180,5016,0,5016,2164,539,1625,30.13927577,MU,30,30077
Power County,Idaho,ID,7538,4133,0,4133,3405,443,2962,45.17113293,MU,16,16077
Poweshiek County,Iowa,IA,18815,9115,0,9115,9700,1788,7912,51.55461068,MR,19,19157
Powhatan County,Virginia,VA,22377,2282,0,2282,20095,293,19802,89.80202887,MR,51,51145
Prairie County,Arkansas,AR,9539,0,0,0,9539,412,9127,100,CR,5,5117
Prairie County,Montana,MT,1199,0,0,0,1199,196,1003,100,CR,30,30079
Pratt County,Kansas,KS,9647,6448,0,6448,3199,706,2493,33.16056805,MU,20,20151
Preble County,Ohio,OH,42337,7883,0,7883,34454,2952,31502,81.38035288,MR,39,39135
Prentiss County,Mississippi,MS,25556,6115,0,6115,19441,505,18936,76.07215527,MR,28,28117
Presidio County,Texas,TX,7304,4192,0,4192,3112,64,3048,42.6067908,MU,48,48377
Presque Isle County,Michigan,MI,14411,3089,0,3089,11322,412,10910,78.56498508,MR,26,26141
Preston County,West Virginia,WV,29334,3518,0,3518,25816,1101,24715,88.00709075,MR,54,54077
Price County,Wisconsin,WI,15822,0,0,0,15822,653,15169,100,CR,55,55099
Prince Edward County,Virginia,VA,19720,5652,0,5652,14068,438,13630,71.33874239,MR,51,51147
Prince George County,Virginia,VA,33047,13331,13331,0,19716,332,19384,59.66048355,MR,51,51149
Prince George's County,Maryland,MD,801515,780543,780543,0,20972,597,20375,2.616544918,MU,24,24033
Prince of Wales-Outer Ketchikan Census Area,Alaska,AK,6146,0,0,0,6146,8,6138,100,CR,2,2201
Prince William County,Virginia,VA,280813,254890,254890,0,25923,398,25525,9.231410227,MU,51,51153
Providence County,Rhode Island,RI,621602,584366,584366,0,37236,457,36779,5.990328216,MU,44,44007
Prowers County,Colorado,CO,14483,8997,0,8997,5486,623,4863,37.87889249,MU,8,8099
Pueblo County,Colorado,CO,141472,123405,123405,0,18067,836,17231,12.77072495,MU,8,8101
Pulaski County,Arkansas,AR,361474,315450,304747,10703,46024,548,45476,12.7323127,MU,5,5119
Pulaski County,Georgia,GA,9588,3980,0,3980,5608,150,5458,58.48977889,MR,13,13235
Pulaski County,Illinois,IL,7348,0,0,0,7348,387,6961,100,CR,17,17153
Pulaski County,Indiana,IN,13755,2531,0,2531,11224,1626,9598,81.59941839,MR,18,18131
Pulaski County,Kentucky,KY,56217,22211,0,22211,34006,2967,31039,60.49059893,MR,21,21199
Pulaski County,Missouri,MO,41165,20923,0,20923,20242,545,19697,49.17284101,MU,29,29169
Pulaski County,Virginia,VA,35127,17269,0,17269,17858,245,17613,50.83838643,MR,51,51155
Pushmataha County,Oklahoma,OK,11667,0,0,0,11667,656,11011,100,CR,40,40127
Putnam County,Florida,FL,70423,32122,0,32122,38301,507,37794,54.38706105,MR,12,12107
Putnam County,Georgia,GA,18812,4706,0,4706,14106,510,13596,74.98405273,MR,13,13237
Putnam County,Illinois,IL,6086,0,0,0,6086,388,5698,100,CR,17,17155
Putnam County,Indiana,IN,36019,9669,0,9669,26350,847,25503,73.15583442,MR,18,18133
Putnam County,Missouri,MO,5223,0,0,0,5223,723,4500,100,CR,29,29171
Putnam County,New York,NY,95745,72591,69209,3382,23154,42,23112,24.18298606,MU,36,36079
Putnam County,Ohio,OH,34726,5229,0,5229,29497,2830,26667,84.9421183,MR,39,39137
Putnam County,Tennessee,TN,62315,37816,0,37816,24499,1092,23407,39.31477172,MU,47,47141
Putnam County,West Virginia,WV,51589,30765,30765,0,20824,562,20262,40.36519413,MU,54,54079
Quay County,New Mexico,NM,10155,5911,0,5911,4244,781,3463,41.79222058,MU,35,35037
Queen Anne's County,Maryland,MD,40563,15931,0,15931,24632,1256,23376,60.72529152,MR,24,24035
Queens County,New York,NY,2229379,2229379,2229379,0,0,0,0,0,MU,36,36081
Quitman County,Georgia,GA,2598,1045,0,1045,1553,16,1537,59.77675135,MR,13,13239
Quitman County,Mississippi,MS,10117,3728,0,3728,6389,216,6173,63.15113176,MR,28,28119
Rabun County,Georgia,GA,15050,0,0,0,15050,73,14977,100,CR,13,13241
Racine County,Wisconsin,WI,188831,164872,130229,34643,23959,1351,22608,12.68806499,MU,55,55101
Radford city,Virginia,VA,15859,15443,0,15443,416,0,416,2.623116212,MU,51,51750
Rains County,Texas,TX,9139,0,0,0,9139,532,8607,100,CR,48,48379
Raleigh County,West Virginia,WV,79220,47233,0,47233,31987,287,31700,40.37742994,MU,54,54081
Ralls County,Missouri,MO,9626,257,0,257,9369,851,8518,97.33014752,MR,29,29173
Ramsey County,Minnesota,MN,511035,510270,510270,0,765,0,765,0.149696205,MU,27,27123
Ramsey County,North Dakota,ND,12066,7466,0,7466,4600,644,3956,38.12365324,MU,38,38071
Randall County,Texas,TX,104312,90251,73935,16316,14061,471,13590,13.47975305,MU,48,48381
Randolph County,Alabama,AL,22380,4812,0,4812,17568,621,16947,78.49865952,MR,1,1111
Randolph County,Arkansas,AR,18195,5687,0,5687,12508,712,11796,68.74416048,MR,5,5121
Randolph County,Georgia,GA,7791,3717,0,3717,4074,201,3873,52.29110512,MR,13,13243
Randolph County,Illinois,IL,33893,19420,0,19420,14473,1394,13079,42.70203287,MU,17,17157
Randolph County,Indiana,IN,27401,9966,1378,8588,17435,2126,15309,63.62906463,MR,18,18135
Randolph County,Missouri,MO,24663,11935,0,11935,12728,943,11785,51.60767141,MR,29,29175
Randolph County,North Carolina,NC,130454,51803,19898,31905,78651,1694,76957,60.29021724,MR,37,37151
Randolph County,West Virginia,WV,28262,9715,0,9715,18547,346,18201,65.62522115,MR,54,54083
Rankin County,Mississippi,MS,115327,69204,44103,25101,46123,1084,45039,39.99323662,MU,28,28121
Ransom County,North Dakota,ND,5890,0,0,0,5890,865,5025,100,CR,38,38073
Rapides Parish,Louisiana,LA,126337,78525,78525,0,47812,1422,46390,37.84481189,MU,22,22079
Rappahannock County,Virginia,VA,6983,0,0,0,6983,486,6497,100,CR,51,51157
Ravalli County,Montana,MT,36070,6072,0,6072,29998,1606,28392,83.16606598,MR,30,30081
Rawlins County,Kansas,KS,2966,0,0,0,2966,599,2367,100,CR,20,20153
Ray County,Missouri,MO,23354,6758,0,6758,16596,1251,15345,71.06277297,MR,29,29177
Reagan County,Texas,TX,3326,2835,0,2835,491,162,329,14.76247745,MU,48,48383
Real County,Texas,TX,3047,0,0,0,3047,134,2913,100,CR,48,48385
Red Lake County,Minnesota,MN,4299,0,0,0,4299,536,3763,100,CR,27,27125
Red River County,Texas,TX,14314,3632,0,3632,10682,815,9867,74.62624004,MR,48,48387
Red River Parish,Louisiana,LA,9622,2608,0,2608,7014,264,6750,72.89544793,MR,22,22081
Red Willow County,Nebraska,NE,11448,7868,0,7868,3580,607,2973,31.27183788,MU,31,31145
Redwood County,Minnesota,MN,16815,5209,0,5209,11606,2513,9093,69.02170681,MR,27,27127
Reeves County,Texas,TX,13137,10833,0,10833,2304,38,2266,17.53825074,MU,48,48389
Refugio County,Texas,TX,7828,3060,0,3060,4768,265,4503,60.90955544,MR,48,48391
Reno County,Kansas,KS,64790,44341,0,44341,20449,2195,18254,31.56196944,MU,20,20155
Rensselaer County,New York,NY,152538,103642,99655,3987,48896,797,48099,32.05496335,MU,36,36083
Renville County,Minnesota,MN,17154,0,0,0,17154,2451,14703,100,CR,27,27129
Renville County,North Dakota,ND,2610,0,0,0,2610,576,2034,100,CR,38,38075
Republic County,Kansas,KS,5835,0,0,0,5835,982,4853,100,CR,20,20157
Reynolds County,Missouri,MO,6689,0,0,0,6689,252,6437,100,CR,29,29179
Rhea County,Tennessee,TN,28400,9108,0,9108,19292,463,18829,67.92957746,MR,47,47143
Rice County,Kansas,KS,10761,6097,0,6097,4664,693,3971,43.34169687,MU,20,20159
Rice County,Minnesota,MN,56665,39028,0,39028,17637,2251,15386,31.12503309,MU,27,27131
Rich County,Utah,UT,1961,0,0,0,1961,181,1780,100,CR,49,49033
Richardson County,Nebraska,NE,9531,4428,0,4428,5103,942,4161,53.54107649,MR,31,31147
Richland County,Illinois,IL,16149,8734,0,8734,7415,1051,6364,45.9161558,MU,17,17159
Richland County,Montana,MT,9667,5407,0,5407,4260,878,3382,44.06744595,MU,30,30083
Richland County,North Dakota,ND,17998,8672,0,8672,9326,1594,7732,51.81686854,MR,38,38077
Richland County,Ohio,OH,128852,90692,79593,11099,38160,3100,35060,29.61537268,MU,39,39139
Richland County,South Carolina,SC,320677,279512,279512,0,41165,702,40463,12.83690442,MU,45,45079
Richland County,Wisconsin,WI,17924,4966,0,4966,12958,2120,10838,72.29413077,MR,55,55103
Richland Parish,Louisiana,LA,20981,7634,0,7634,13347,708,12639,63.61469901,MR,22,22083
Richmond city,Virginia,VA,197790,197790,197790,0,0,0,0,0,MU,51,51760
Richmond County,Georgia,GA,199775,184282,184282,0,15493,369,15124,7.755224628,MU,13,13245
Richmond County,New York,NY,443728,443728,443728,0,0,0,0,0,MU,36,36085
Richmond County,North Carolina,NC,46564,25229,0,25229,21335,321,21014,45.81865819,MU,37,37153
Richmond County,Virginia,VA,8809,1415,0,1415,7394,305,7089,83.93688273,MR,51,51159
Riley County,Kansas,KS,62843,53605,0,53605,9238,919,8319,14.70012571,MU,20,20161
Ringgold County,Iowa,IA,5469,0,0,0,5469,1169,4300,100,CR,19,19159
Rio Arriba County,New Mexico,NM,41190,17678,0,17678,23512,544,22968,57.08181597,MR,35,35039
Rio Blanco County,Colorado,CO,5986,0,0,0,5986,264,5722,100,CR,8,8103
Rio Grande County,Colorado,CO,12413,4809,0,4809,7604,710,6894,61.25835817,MR,8,8105
Ripley County,Indiana,IN,26523,4812,0,4812,21711,1965,19746,81.85725597,MR,18,18137
Ripley County,Missouri,MO,13509,0,0,0,13509,704,12805,100,CR,29,29181
Ritchie County,West Virginia,WV,10343,0,0,0,10343,404,9939,100,CR,54,54085
Riverside County,California,CA,1545387,1439546,1378114,61432,105841,2980,102861,6.848834628,MU,6,6065
Roane County,Tennessee,TN,51910,26088,0,26088,25822,500,25322,49.74378732,MU,47,47145
Roane County,West Virginia,WV,15446,3301,0,3301,12145,481,11664,78.6287712,MR,54,54087
Roanoke city,Virginia,VA,94911,94911,94911,0,0,0,0,0,MU,51,51770
Roanoke County,Virginia,VA,85778,66924,66924,0,18854,209,18645,21.97999487,MU,51,51161
Roberts County,South Dakota,SD,10016,0,0,0,10016,1307,8709,100,CR,46,46109
Roberts County,Texas,TX,887,0,0,0,887,91,796,100,CR,48,48393
Robertson County,Kentucky,KY,2266,0,0,0,2266,511,1755,100,CR,21,21201
Robertson County,Tennessee,TN,54433,22979,19531,3448,31454,2643,28811,57.78479966,MR,47,47147
Robertson County,Texas,TX,16000,4379,0,4379,11621,1106,10515,72.63125,MR,48,48395
Robeson County,North Carolina,NC,123339,42540,0,42540,80799,2453,78346,65.5096928,MR,37,37155
Rock County,Minnesota,MN,9721,4494,0,4494,5227,1720,3507,53.77018825,MR,27,27133
Rock County,Nebraska,NE,1756,0,0,0,1756,357,1399,100,CR,31,31149
Rock County,Wisconsin,WI,152307,118701,108126,10575,33606,2762,30844,22.06464575,MU,55,55105
Rock Island County,Illinois,IL,149374,132797,132797,0,16577,1064,15513,11.09764752,MU,17,17161
Rockbridge County,Virginia,VA,20808,764,0,764,20044,978,19066,96.32833526,MR,51,51163
Rockcastle County,Kentucky,KY,16582,2819,0,2819,13763,1077,12686,82.99963816,MR,21,21203
Rockdale County,Georgia,GA,70111,59547,59547,0,10564,119,10445,15.06753576,MU,13,13247
Rockingham County,New Hampshire,NH,277359,195666,179137,16529,81693,537,81156,29.45388468,MU,33,33015
Rockingham County,North Carolina,NC,91928,37419,0,37419,54509,1620,52889,59.29531808,MR,37,37157
Rockingham County,Virginia,VA,67725,22247,12237,10010,45478,3703,41775,67.15097822,MR,51,51165
Rockland County,New York,NY,286753,283924,283924,0,2829,0,2829,0.986563349,MU,36,36087
Rockwall County,Texas,TX,43080,34289,31609,2680,8791,316,8475,20.40622098,MU,48,48397
Roger Mills County,Oklahoma,OK,3436,0,0,0,3436,770,2666,100,CR,40,40129
Rogers County,Oklahoma,OK,70641,30440,5087,25353,40201,1630,38571,56.90887728,MR,40,40131
Rolette County,North Dakota,ND,13674,0,0,0,13674,853,12821,100,CR,38,38079
Rooks County,Kansas,KS,5685,0,0,0,5685,540,5145,100,CR,20,20163
Roosevelt County,Montana,MT,10620,6381,0,6381,4239,747,3492,39.91525424,MU,30,30085
Roosevelt County,New Mexico,NM,18018,11524,0,11524,6494,1050,5444,36.04173604,MU,35,35041
Roscommon County,Michigan,MI,25469,11094,0,11094,14375,63,14312,56.44116377,MR,26,26143
Roseau County,Minnesota,MN,16338,2699,0,2699,13639,1433,12206,83.48023014,MR,27,27135
Rosebud County,Montana,MT,9383,0,0,0,9383,569,8814,100,CR,30,30087
Ross County,Ohio,OH,73345,30656,0,30656,42689,1558,41131,58.20301316,MR,39,39141
Routt County,Colorado,CO,19690,10055,0,10055,9635,717,8918,48.93346877,MU,8,8107
Rowan County,Kentucky,KY,22094,6702,0,6702,15392,614,14778,69.66597266,MR,21,21205
Rowan County,North Carolina,NC,130340,76616,28547,48069,53724,1125,52599,41.218352,MU,37,37159
Runnels County,Texas,TX,11495,7249,0,7249,4246,1028,3218,36.93779904,MU,48,48399
Rush County,Indiana,IN,18261,7331,0,7331,10930,1143,9787,59.85433437,MR,18,18139
Rush County,Kansas,KS,3551,0,0,0,3551,336,3215,100,CR,20,20165
Rusk County,Texas,TX,47372,15476,0,15476,31896,953,30943,67.33091278,MR,48,48401
Rusk County,Wisconsin,WI,15347,3935,0,3935,11412,1224,10188,74.35980973,MR,55,55107
Russell County,Alabama,AL,49756,31700,31700,0,18056,553,17503,36.28909076,MU,1,1113
Russell County,Kansas,KS,7370,4329,0,4329,3041,537,2504,41.26187246,MU,20,20167
Russell County,Kentucky,KY,16315,0,0,0,16315,1625,14690,100,CR,21,21207
Russell County,Virginia,VA,30308,3340,0,3340,26968,1031,25937,88.97980731,MR,51,51167
Rutherford County,North Carolina,NC,62899,23242,0,23242,39657,836,38821,63.04869712,MR,37,37161
Rutherford County,Tennessee,TN,182023,137004,137004,0,45019,1621,43398,24.73258874,MU,47,47149
Rutland County,Vermont,VT,63400,24467,0,24467,38933,807,38126,61.40851735,MR,50,50021
Sabine County,Texas,TX,10469,0,0,0,10469,203,10266,100,CR,48,48403
Sabine Parish,Louisiana,LA,23459,2818,0,2818,20641,432,20209,87.98755275,MR,22,22085
Sac County,Iowa,IA,11529,0,0,0,11529,1534,9995,100,CR,19,19161
Sacramento County,California,CA,1223499,1194425,1191957,2468,29074,1722,27352,2.376299449,MU,6,6067
Sagadahoc County,Maine,ME,35214,14422,0,14422,20792,256,20536,59.04469813,MR,23,23023
Saginaw County,Michigan,MI,210039,145874,141269,4605,64165,3444,60721,30.5490885,MU,26,26145
Saguache County,Colorado,CO,5917,0,0,0,5917,588,5329,100,CR,8,8109
Salem city,Virginia,VA,24747,24747,24747,0,0,0,0,0,MU,51,51775
Salem County,New Jersey,NJ,64285,37868,25319,12549,26417,1114,25303,41.09356771,MU,34,34033
Saline County,Arkansas,AR,83529,41989,40961,1028,41540,479,41061,49.73123107,MU,5,5125
Saline County,Illinois,IL,26733,16916,0,16916,9817,834,8983,36.72240302,MU,17,17165
Saline County,Kansas,KS,53597,45551,0,45551,8046,1047,6999,15.01203426,MU,20,20169
Saline County,Missouri,MO,23756,12711,0,12711,11045,1631,9414,46.49351743,MU,29,29195
Saline County,Nebraska,NE,13843,5883,0,5883,7960,1409,6551,57.50198656,MR,31,31151
Salt Lake County,Utah,UT,898387,887916,887916,0,10471,209,10262,1.165533339,MU,49,49035
Saluda County,South Carolina,SC,19181,3580,0,3580,15601,1182,14419,81.33569678,MR,45,45081
Sampson County,North Carolina,NC,60161,8907,0,8907,51254,2076,49178,85.19472748,MR,37,37163
San Augustine County,Texas,TX,8946,0,0,0,8946,219,8727,100,CR,48,48405
San Benito County,California,CA,53234,41283,0,41283,11951,1099,10852,22.44993801,MU,6,6069
San Bernardino County,California,CA,1709434,1612981,1466868,146113,96453,1719,94734,5.642393915,MU,6,6071
San Diego County,California,CA,2813833,2705075,2674996,30079,108758,7076,101682,3.865119216,MU,6,6073
San Francisco County,California,CA,776733,776733,776733,0,0,0,0,0,MU,6,6075
San Jacinto County,Texas,TX,22246,0,0,0,22246,509,21737,100,CR,48,48407
San Joaquin County,California,CA,563598,507709,497571,10138,55889,6858,49031,9.916465282,MU,6,6077
San Juan County,Colorado,CO,558,0,0,0,558,0,558,100,CR,8,8111
San Juan County,New Mexico,NM,113801,67413,53168,14245,46388,1069,45319,40.76238346,MU,35,35045
San Juan County,Utah,UT,14413,2981,0,2981,11432,304,11128,79.31728301,MR,49,49037
San Juan County,Washington,WA,14077,0,0,0,14077,440,13637,100,CR,53,53055
San Luis Obispo County,California,CA,246681,200246,120427,79819,46435,2622,43813,18.82390618,MU,6,6079
San Mateo County,California,CA,707161,697471,675371,22100,9690,228,9462,1.370267874,MU,6,6081
San Miguel County,Colorado,CO,6594,0,0,0,6594,97,6497,100,CR,8,8113
San Miguel County,New Mexico,NM,30126,18000,0,18000,12126,290,11836,40.25094603,MU,35,35047
San Patricio County,Texas,TX,67138,53042,17474,35568,14096,763,13333,20.99556138,MU,48,48409
San Saba County,Texas,TX,6186,2505,0,2505,3681,464,3217,59.50533463,MR,48,48411
Sanborn County,South Dakota,SD,2675,0,0,0,2675,761,1914,100,CR,46,46111
Sanders County,Montana,MT,10227,0,0,0,10227,630,9597,100,CR,30,30089
Sandoval County,New Mexico,NM,89908,68906,65959,2947,21002,161,20841,23.35943409,MU,35,35043
Sandusky County,Ohio,OH,61792,36109,0,36109,25683,1875,23808,41.56363283,MU,39,39143
Sangamon County,Illinois,IL,188951,161365,153543,7822,27586,1201,26385,14.59955226,MU,17,17167
Sanilac County,Michigan,MI,44547,5953,3050,2903,38594,3487,35107,86.63658608,MR,26,26151
Sanpete County,Utah,UT,22763,10263,0,10263,12500,435,12065,54.9136757,MR,49,49039
Santa Barbara County,California,CA,399347,380031,359727,20304,19316,1943,17373,4.836896233,MU,6,6083
Santa Clara County,California,CA,1682585,1661581,1661581,0,21004,1078,19926,1.248317321,MU,6,6085
Santa Cruz County,Arizona,AZ,38381,25939,0,25939,12442,236,12206,32.41708137,MU,4,4023
Santa Cruz County,California,CA,255602,218122,218122,0,37480,714,36766,14.66342204,MU,6,6087
Santa Fe County,New Mexico,NM,129292,97465,80509,16956,31827,643,31184,24.61637224,MU,35,35049
Santa Rosa County,Florida,FL,117743,83178,83178,0,34565,377,34188,29.35630993,MU,12,12113
Sarasota County,Florida,FL,325957,309959,309959,0,15998,439,15559,4.908009339,MU,12,12115
Saratoga County,New York,NY,200635,137332,125286,12046,63303,951,62352,31.55132454,MU,36,36091
Sargent County,North Dakota,ND,4366,0,0,0,4366,688,3678,100,CR,38,38081
Sarpy County,Nebraska,NE,122595,113638,110233,3405,8957,722,8235,7.306170725,MU,31,31153
Sauk County,Wisconsin,WI,55225,27659,0,27659,27566,3368,24198,49.915799,MU,55,55111
Saunders County,Nebraska,NE,19830,3945,0,3945,15885,2509,13376,80.10590015,MR,31,31155
Sawyer County,Wisconsin,WI,16196,0,0,0,16196,248,15948,100,CR,55,55113
Schenectady County,New York,NY,146555,133391,133391,0,13164,185,12979,8.982293337,MU,36,36093
Schleicher County,Texas,TX,2935,0,0,0,2935,349,2586,100,CR,48,48413
Schley County,Georgia,GA,3766,0,0,0,3766,47,3719,100,CR,13,13249
Schoharie County,New York,NY,31582,5312,0,5312,26270,1115,25155,83.18029257,MR,36,36095
Schoolcraft County,Michigan,MI,8903,3672,0,3672,5231,68,5163,58.75547568,MR,26,26153
Schuyler County,Illinois,IL,7189,3217,0,3217,3972,709,3263,55.25107804,MR,17,17169
Schuyler County,Missouri,MO,4170,0,0,0,4170,768,3402,100,CR,29,29197
Schuyler County,New York,NY,19224,3922,0,3922,15302,628,14674,79.59841864,MR,36,36097
Schuylkill County,Pennsylvania,PA,150336,95497,3450,92047,54839,976,53863,36.47762346,MU,42,42107
Scioto County,Ohio,OH,79195,39132,0,39132,40063,849,39214,50.58778963,MR,39,39145
Scotland County,Missouri,MO,4983,0,0,0,4983,1220,3763,100,CR,29,29199
Scotland County,North Carolina,NC,35998,16980,0,16980,19018,546,18472,52.83071282,MR,37,37165
Scott County,Arkansas,AR,10996,2978,0,2978,8018,981,7037,72.91742452,MR,5,5127
Scott County,Illinois,IL,5537,0,0,0,5537,404,5133,100,CR,17,17171
Scott County,Indiana,IN,22960,11308,0,11308,11652,547,11105,50.74912892,MR,18,18143
Scott County,Iowa,IA,158668,135109,131802,3307,23559,1536,22023,14.84798447,MU,19,19163
Scott County,Kansas,KS,5120,3687,0,3687,1433,332,1101,27.98828125,MU,20,20171
Scott County,Kentucky,KY,33061,19030,0,19030,14031,1077,12954,42.43973262,MU,21,21209
Scott County,Minnesota,MN,89498,65036,54714,10322,24462,1638,22824,27.33245436,MU,27,27139
Scott County,Mississippi,MS,28423,8282,0,8282,20141,781,19360,70.86162615,MR,28,28123
Scott County,Missouri,MO,40422,25072,0,25072,15350,851,14499,37.97437039,MU,29,29201
Scott County,Tennessee,TN,21127,3162,0,3162,17965,137,17828,85.03336962,MR,47,47151
Scott County,Virginia,VA,23403,4389,1756,2633,19014,1556,17458,81.2459941,MR,51,51169
Scotts Bluff County,Nebraska,NE,36951,24591,0,24591,12360,1827,10533,33.44970366,MU,31,31157
Screven County,Georgia,GA,15374,2555,0,2555,12819,559,12260,83.38103291,MR,13,13251
Scurry County,Texas,TX,16361,10966,0,10966,5395,563,4832,32.97475704,MU,48,48415
Searcy County,Arkansas,AR,8261,0,0,0,8261,617,7644,100,CR,5,5129
Sebastian County,Arkansas,AR,115071,90945,84088,6857,24126,580,23546,20.96618609,MU,5,5131
Sedgwick County,Colorado,CO,2747,0,0,0,2747,278,2469,100,CR,8,8115
Sedgwick County,Kansas,KS,452869,413159,413159,0,39710,1894,37816,8.76854013,MU,20,20173
Seminole County,Florida,FL,365196,350439,350439,0,14757,285,14472,4.040843821,MU,12,12117
Seminole County,Georgia,GA,9369,2612,0,2612,6757,373,6384,72.12082399,MR,13,13253
Seminole County,Oklahoma,OK,24894,8718,0,8718,16176,975,15201,64.97951314,MR,40,40133
Seneca County,New York,NY,33342,14198,0,14198,19144,1032,18112,57.41707156,MR,36,36099
Seneca County,Ohio,OH,58683,31807,0,31807,26876,2925,23951,45.79861289,MU,39,39147
Sequatchie County,Tennessee,TN,11370,0,0,0,11370,180,11190,100,CR,47,47153
Sequoyah County,Oklahoma,OK,38972,12693,178,12515,26279,774,25505,67.4304629,MR,40,40135
Sevier County,Arkansas,AR,15757,5781,0,5781,9976,733,9243,63.31154408,MR,5,5133
Sevier County,Tennessee,TN,71170,24887,8246,16641,46283,871,45412,65.03161444,MR,47,47155
Sevier County,Utah,UT,18842,6864,0,6864,11978,401,11577,63.57074621,MR,49,49041
Seward County,Kansas,KS,22510,19320,0,19320,3190,267,2923,14.17147934,MU,20,20175
Seward County,Nebraska,NE,16496,6333,0,6333,10163,1641,8522,61.60887488,MR,31,31159
Shackelford County,Texas,TX,3302,0,0,0,3302,132,3170,100,CR,48,48417
Shannon County,Missouri,MO,8324,0,0,0,8324,576,7748,100,CR,29,29203
Shannon County,South Dakota,SD,12466,3435,0,3435,9031,211,8820,72.44505054,MR,46,46113
Sharkey County,Mississippi,MS,6580,0,0,0,6580,248,6332,100,CR,28,28125
Sharp County,Arkansas,AR,17119,2939,0,2939,14180,629,13551,82.83194112,MR,5,5135
Shasta County,California,CA,163256,112565,105258,7307,50691,997,49694,31.05000735,MU,6,6089
Shawano County,Wisconsin,WI,40664,9377,0,9377,31287,2964,28323,76.94029117,MR,55,55115
Shawnee County,Kansas,KS,169871,142541,142541,0,27330,1047,26283,16.08867906,MU,20,20177
Sheboygan County,Wisconsin,WI,112646,79790,68727,11063,32856,1769,31087,29.16748043,MU,55,55117
Shelby County,Alabama,AL,143293,92176,86544,5632,51117,527,50590,35.67306149,MU,1,1117
Shelby County,Illinois,IL,22893,4710,0,4710,18183,1978,16205,79.42602542,MR,17,17173
Shelby County,Indiana,IN,43445,18952,0,18952,24493,1462,23031,56.37702843,MR,18,18145
Shelby County,Iowa,IA,13173,5029,0,5029,8144,2140,6004,61.82342671,MR,19,19165
Shelby County,Kentucky,KY,33337,13291,0,13291,20046,2239,17807,60.13138555,MR,21,21211
Shelby County,Missouri,MO,6799,0,0,0,6799,1318,5481,100,CR,29,29205
Shelby County,Ohio,OH,47910,20480,0,20480,27430,2663,24767,57.25318305,MR,39,39149
Shelby County,Tennessee,TN,897472,867801,867801,0,29671,640,29031,3.306064145,MU,47,47157
Shelby County,Texas,TX,25224,5586,0,5586,19638,1195,18443,77.85442436,MR,48,48419
Shenandoah County,Virginia,VA,35075,8332,0,8332,26743,1284,25459,76.24518888,MR,51,51171
Sherburne County,Minnesota,MN,64417,28087,5966,22121,36330,1217,35113,56.39815577,MR,27,27141
Sheridan County,Kansas,KS,2813,0,0,0,2813,811,2002,100,CR,20,20179
Sheridan County,Montana,MT,4105,0,0,0,4105,661,3444,100,CR,30,30091
Sheridan County,Nebraska,NE,6198,0,0,0,6198,1212,4986,100,CR,31,31161
Sheridan County,North Dakota,ND,1710,0,0,0,1710,615,1095,100,CR,38,38083
Sheridan County,Wyoming,WY,26560,17046,0,17046,9514,995,8519,35.82078313,MU,56,56033
Sherman County,Kansas,KS,6760,4838,0,4838,1922,487,1435,28.43195266,MU,20,20181
Sherman County,Nebraska,NE,3318,0,0,0,3318,664,2654,100,CR,31,31163
Sherman County,Oregon,OR,1934,0,0,0,1934,335,1599,100,CR,41,41055
Sherman County,Texas,TX,3186,0,0,0,3186,238,2948,100,CR,48,48421
Shiawassee County,Michigan,MI,71687,32653,174,32479,39034,2609,36425,54.45059774,MR,26,26155
Shoshone County,Idaho,ID,13771,3320,0,3320,10451,80,10371,75.89136591,MR,16,16079
Sibley County,Minnesota,MN,15356,0,0,0,15356,2505,12851,100,CR,27,27143
Sierra County,California,CA,3555,0,0,0,3555,85,3470,100,CR,6,6091
Sierra County,New Mexico,NM,13270,8827,0,8827,4443,251,4192,33.4815373,MU,35,35051
Silver Bow County,Montana,MT,34606,30509,0,30509,4097,244,3853,11.83898746,MU,30,30093
Simpson County,Kentucky,KY,16405,9087,0,9087,7318,1016,6302,44.60835111,MU,21,21213
Simpson County,Mississippi,MS,27639,4433,0,4433,23206,740,22466,83.9610695,MR,28,28127
Sioux County,Iowa,IA,31589,14388,0,14388,17201,3966,13235,54.45249929,MR,19,19167
Sioux County,Nebraska,NE,1475,0,0,0,1475,645,830,100,CR,31,31165
Sioux County,North Dakota,ND,4044,0,0,0,4044,261,3783,100,CR,38,38085
Siskiyou County,California,CA,44301,15666,0,15666,28635,1370,27265,64.6373671,MR,6,6093
Sitka City and Borough,Alaska,AK,8835,7308,0,7308,1527,0,1527,17.28353141,MU,2,2220
Skagit County,Washington,WA,102979,69057,51170,17887,33922,1273,32649,32.94069665,MU,53,53057
Skagway-Hoonah-Angoon Census Area,Alaska,AK,3436,0,0,0,3436,17,3419,100,CR,2,2232
Skamania County,Washington,WA,9872,0,0,0,9872,174,9698,100,CR,53,53059
Slope County,North Dakota,ND,767,0,0,0,767,337,430,100,CR,38,38087
Smith County,Kansas,KS,4536,0,0,0,4536,998,3538,100,CR,20,20183
Smith County,Mississippi,MS,16182,0,0,0,16182,922,15260,100,CR,28,28129
Smith County,Tennessee,TN,17712,3633,0,3633,14079,897,13182,79.48848238,MR,47,47159
Smith County,Texas,TX,174706,107949,102295,5654,66757,1815,64942,38.21105171,MU,48,48423
Smyth County,Virginia,VA,33081,9803,0,9803,23278,725,22553,70.36667574,MR,51,51173
Snohomish County,Washington,WA,606024,539399,521887,17512,66625,1595,65030,10.99378902,MU,53,53061
Snyder County,Pennsylvania,PA,37546,10764,0,10764,26782,1809,24973,71.3311671,MR,42,42109
Socorro County,New Mexico,NM,18078,8422,0,8422,9656,340,9316,53.41298816,MR,35,35053
Solano County,California,CA,394542,378309,348889,29420,16233,1319,14914,4.114390863,MU,6,6095
Somerset County,Maine,ME,50888,12985,0,12985,37903,1014,36889,74.48317875,MR,23,23025
Somerset County,Maryland,MD,24747,11956,0,11956,12791,595,12196,51.68707318,MR,24,24039
Somerset County,New Jersey,NJ,297490,276986,276986,0,20504,536,19968,6.892332515,MU,34,34035
Somerset County,Pennsylvania,PA,80023,20411,7045,13366,59612,1858,57754,74.49358309,MR,42,42111
Somervell County,Texas,TX,6809,0,0,0,6809,261,6548,100,CR,48,48425
Sonoma County,California,CA,458614,393093,345383,47710,65521,4630,60891,14.28674223,MU,6,6097
Southampton County,Virginia,VA,17482,286,0,286,17196,418,16778,98.36403158,MR,51,51175
Southeast Fairbanks Census Area,Alaska,AK,6174,0,0,0,6174,85,6089,100,CR,2,2240
Spalding County,Georgia,GA,58417,34982,34982,0,23435,568,22867,40.11674684,MU,13,13255
Spartanburg County,South Carolina,SC,253791,164341,157336,7005,89450,1575,87875,35.24553668,MU,45,45083
Spencer County,Indiana,IN,20391,0,0,0,20391,1451,18940,100,CR,18,18147
Spencer County,Kentucky,KY,11766,0,0,0,11766,946,10820,100,CR,21,21215
Spink County,South Dakota,SD,7454,2970,0,2970,4484,1044,3440,60.15562114,MR,46,46115
Spokane County,Washington,WA,417939,359697,335584,24113,58242,2493,55749,13.93552648,MU,53,53063
Spotsylvania County,Virginia,VA,90395,58933,57070,1863,31462,372,31090,34.8050224,MU,51,51177
St. Bernard Parish,Louisiana,LA,67229,64534,64534,0,2695,0,2695,4.008686727,MU,22,22087
St. Charles County,Missouri,MO,283883,261265,261265,0,22618,869,21749,7.967366838,MU,29,29183
St. Charles Parish,Louisiana,LA,48072,41342,6834,34508,6730,11,6719,13.99983358,MU,22,22089
St. Clair County,Alabama,AL,64742,7968,0,7968,56774,1575,55199,87.6926879,MR,1,1115
St. Clair County,Illinois,IL,256082,229191,222321,6870,26891,2016,24875,10.50093329,MU,17,17163
St. Clair County,Michigan,MI,164235,102214,102214,0,62021,1918,60103,37.76357049,MU,26,26147
St. Clair County,Missouri,MO,9652,0,0,0,9652,1102,8550,100,CR,29,29185
St. Croix County,Wisconsin,WI,63155,26954,0,26954,36201,2874,33327,57.32087721,MR,55,55109
St. Francis County,Arkansas,AR,29329,14346,0,14346,14983,463,14520,51.08595588,MR,5,5123
St. Francois County,Missouri,MO,55641,32725,0,32725,22916,683,22233,41.18545677,MU,29,29187
St. Helena Parish,Louisiana,LA,10525,0,0,0,10525,430,10095,100,CR,22,22091
St. James Parish,Louisiana,LA,21216,13796,0,13796,7420,45,7375,34.97360483,MU,22,22093
St. John the Baptist Parish,Louisiana,LA,43044,36817,0,36817,6227,0,6227,14.46659232,MU,22,22095
St. Johns County,Florida,FL,123135,94573,94573,0,28562,235,28327,23.19567954,MU,12,12109
St. Joseph County,Indiana,IN,265559,243099,238980,4119,22460,1973,20487,8.457630884,MU,18,18141
St. Joseph County,Michigan,MI,62422,27458,0,27458,34964,1806,33158,56.01230335,MR,26,26149
St. Landry Parish,Louisiana,LA,87700,48457,0,48457,39243,1195,38048,44.74686431,MU,22,22097
St. Lawrence County,New York,NY,111931,43871,0,43871,68060,2684,65376,60.80531756,MR,36,36089
St. Louis city,Missouri,MO,348189,348189,348189,0,0,0,0,0,MU,29,29510
St. Louis County,Minnesota,MN,200528,127176,91416,35760,73352,1183,72169,36.5794303,MU,27,27137
St. Louis County,Missouri,MO,1016315,1002478,994101,8377,13837,184,13653,1.361487334,MU,29,29189
St. Lucie County,Florida,FL,192695,180990,180990,0,11705,227,11478,6.074366226,MU,12,12111
St. Martin Parish,Louisiana,LA,48583,15722,7802,7920,32861,494,32367,67.63888603,MR,22,22099
St. Mary Parish,Louisiana,LA,53500,44382,0,44382,9118,196,8922,17.04299065,MU,22,22101
St. Mary's County,Maryland,MD,86211,32973,0,32973,53238,1785,51453,61.75314055,MR,24,24037
St. Tammany Parish,Louisiana,LA,191268,143044,143044,0,48224,510,47714,25.21279043,MU,22,22103
Stafford County,Kansas,KS,4789,0,0,0,4789,634,4155,100,CR,20,20185
Stafford County,Virginia,VA,92446,67849,67849,0,24597,214,24383,26.60688402,MU,51,51179
Stanislaus County,California,CA,446997,406578,362226,44352,40419,8781,31638,9.042342566,MU,6,6099
Stanley County,South Dakota,SD,2772,1765,0,1765,1007,259,748,36.32756133,MU,46,46117
Stanly County,North Carolina,NC,58100,18739,0,18739,39361,962,38399,67.74698795,MR,37,37167
Stanton County,Kansas,KS,2406,0,0,0,2406,160,2246,100,CR,20,20187
Stanton County,Nebraska,NE,6455,1578,0,1578,4877,1137,3740,75.55383424,MR,31,31167
Stark County,Illinois,IL,6332,0,0,0,6332,527,5805,100,CR,17,17175
Stark County,North Dakota,ND,22636,15732,0,15732,6904,1444,5460,30.50008835,MU,38,38089
Stark County,Ohio,OH,378098,326036,293074,32962,52062,2575,49487,13.76944602,MU,39,39151
Starke County,Indiana,IN,23556,7031,0,7031,16525,976,15549,70.15197826,MR,18,18149
Starr County,Texas,TX,53597,42524,0,42524,11073,93,10980,20.65973842,MU,48,48427
Staunton city,Virginia,VA,23853,23646,0,23646,207,21,186,0.867815369,MU,51,51790
Ste. Genevieve County,Missouri,MO,17842,4150,0,4150,13692,958,12734,76.74027575,MR,29,29186
Stearns County,Minnesota,MN,133166,75041,64813,10228,58125,7240,50885,43.6485289,MU,27,27145
Steele County,Minnesota,MN,33680,22295,0,22295,11385,1799,9586,33.80344418,MU,27,27147
Steele County,North Dakota,ND,2258,0,0,0,2258,455,1803,100,CR,38,38091
Stephens County,Georgia,GA,25435,10164,0,10164,15271,191,15080,60.0393159,MR,13,13257
Stephens County,Oklahoma,OK,43182,24488,0,24488,18694,1071,17623,43.29118614,MU,40,40137
Stephens County,Texas,TX,9674,6283,0,6283,3391,225,3166,35.05271863,MU,48,48429
Stephenson County,Illinois,IL,48979,29906,0,29906,19073,2154,16919,38.94117887,MU,17,17177
Sterling County,Texas,TX,1393,0,0,0,1393,98,1295,100,CR,48,48431
Steuben County,Indiana,IN,33214,10472,0,10472,22742,1092,21650,68.47112663,MR,18,18151
Steuben County,New York,NY,98726,37120,0,37120,61606,2339,59267,62.40098859,MR,36,36101
Stevens County,Kansas,KS,5463,3773,0,3773,1690,322,1368,30.93538349,MU,20,20189
Stevens County,Minnesota,MN,10053,4861,0,4861,5192,1000,4192,51.64627474,MR,27,27149
Stevens County,Washington,WA,40066,8446,0,8446,31620,1644,29976,78.91978236,MR,53,53065
Stewart County,Georgia,GA,5252,0,0,0,5252,176,5076,100,CR,13,13259
Stewart County,Tennessee,TN,12370,0,0,0,12370,188,12182,100,CR,47,47161
Stillwater County,Montana,MT,8195,0,0,0,8195,882,7313,100,CR,30,30095
Stoddard County,Missouri,MO,29705,8707,0,8707,20998,1178,19820,70.68843629,MR,29,29207
Stokes County,North Carolina,NC,44711,9001,9001,0,35710,1522,34188,79.86848874,MR,37,37169
Stone County,Arkansas,AR,11499,0,0,0,11499,794,10705,100,CR,5,5137
Stone County,Mississippi,MS,13622,2882,0,2882,10740,286,10454,78.84304801,MR,28,28131
Stone County,Missouri,MO,28658,0,0,0,28658,716,27942,100,CR,29,29209
Stonewall County,Texas,TX,1693,0,0,0,1693,114,1579,100,CR,48,48433
Storey County,Nevada,NV,3399,191,0,191,3208,0,3208,94.38070021,MR,32,32029
Story County,Iowa,IA,79981,59868,50414,9454,20113,1594,18519,25.14722247,MU,19,19169
Strafford County,New Hampshire,NH,112233,73263,73248,15,38970,424,38546,34.72240785,MU,33,33017
Stutsman County,North Dakota,ND,21908,15628,0,15628,6280,1475,4805,28.66532773,MU,38,38093
Sublette County,Wyoming,WY,5920,0,0,0,5920,477,5443,100,CR,56,56035
Suffolk city,Virginia,VA,63677,46170,15130,31040,17507,445,17062,27.49344347,MU,51,51800
Suffolk County,Massachusetts,MA,689807,689807,689807,0,0,0,0,0,MU,25,25025
Suffolk County,New York,NY,1419369,1377156,1326967,50189,42213,447,41766,2.974068054,MU,36,36103
Sullivan County,Indiana,IN,21751,7297,0,7297,14454,791,13663,66.45211714,MR,18,18153
Sullivan County,Missouri,MO,7219,0,0,0,7219,1134,6085,100,CR,29,29211
Sullivan County,New Hampshire,NH,40458,14946,0,14946,25512,458,25054,63.05798606,MR,33,33019
Sullivan County,New York,NY,73966,20900,393,20507,53066,600,52466,71.74377417,MR,36,36105
Sullivan County,Pennsylvania,PA,6556,0,0,0,6556,239,6317,100,CR,42,42113
Sullivan County,Tennessee,TN,153048,112474,112474,0,40574,1204,39370,26.51063719,MU,47,47163
Sully County,South Dakota,SD,1556,0,0,0,1556,250,1306,100,CR,46,46119
Summers County,West Virginia,WV,12999,2864,0,2864,10135,354,9781,77.96753596,MR,54,54089
Summit County,Colorado,CO,23548,17248,0,17248,6300,33,6267,26.75386445,MU,8,8117
Summit County,Ohio,OH,542899,519576,519576,0,23323,219,23104,4.29601086,MU,39,39153
Summit County,Utah,UT,29736,13994,0,13994,15742,423,15319,52.93919828,MR,49,49043
Sumner County,Kansas,KS,25946,9751,1315,8436,16195,2180,14015,62.41809913,MR,20,20191
Sumner County,Tennessee,TN,130449,90592,78009,12583,39857,1893,37964,30.55370298,MU,47,47165
Sumter County,Alabama,AL,14798,0,0,0,14798,396,14402,100,CR,1,1119
Sumter County,Florida,FL,53345,26361,10347,16014,26984,959,26025,50.58393476,MR,12,12119
Sumter County,Georgia,GA,33200,18759,0,18759,14441,576,13865,43.49698795,MU,13,13261
Sumter County,South Carolina,SC,104646,64956,64956,0,39690,775,38915,37.92787111,MU,45,45085
Sunflower County,Mississippi,MS,34369,21773,0,21773,12596,394,12202,36.64930606,MU,28,28133
Surry County,North Carolina,NC,71219,21498,0,21498,49721,1635,48086,69.81423497,MR,37,37171
Surry County,Virginia,VA,6829,0,0,0,6829,474,6355,100,CR,51,51181
Susquehanna County,Pennsylvania,PA,42238,7817,5128,2689,34421,1169,33252,81.49296842,MR,42,42115
Sussex County,Delaware,DE,156638,72874,1454,71420,83764,2458,81306,53.47616798,MR,10,10005
Sussex County,New Jersey,NJ,144166,86585,50113,36472,57581,1237,56344,39.94076273,MU,34,34037
Sussex County,Virginia,VA,12504,0,0,0,12504,356,12148,100,CR,51,51183
Sutter County,California,CA,78930,67470,60812,6658,11460,2029,9431,14.51919422,MU,6,6101
Sutton County,Texas,TX,4077,3250,0,3250,827,182,645,20.28452293,MU,48,48435
Suwannee County,Florida,FL,34844,6420,0,6420,28424,1379,27045,81.57502009,MR,12,12121
Swain County,North Carolina,NC,12968,0,0,0,12968,84,12884,100,CR,37,37173
Sweet Grass County,Montana,MT,3609,0,0,0,3609,685,2924,100,CR,30,30097
Sweetwater County,Wyoming,WY,37613,33512,0,33512,4101,416,3685,10.90314519,MU,56,56037
Swift County,Minnesota,MN,11956,6262,0,6262,5694,1503,4191,47.62462362,MU,27,27151
Swisher County,Texas,TX,8378,5065,0,5065,3313,452,2861,39.54404392,MU,48,48437
Switzerland County,Indiana,IN,9065,0,0,0,9065,1023,8042,100,CR,18,18155
Talbot County,Georgia,GA,6498,0,0,0,6498,394,6104,100,CR,13,13263
Talbot County,Maryland,MD,33812,12418,0,12418,21394,836,20558,63.27339406,MR,24,24041
Taliaferro County,Georgia,GA,2077,0,0,0,2077,98,1979,100,CR,13,13265
Talladega County,Alabama,AL,80321,35887,2675,33212,44434,1117,43317,55.32052639,MR,1,1121
Tallahatchie County,Mississippi,MS,14903,3013,0,3013,11890,370,11520,79.78259411,MR,28,28135
Tallapoosa County,Alabama,AL,41475,10007,0,10007,31468,748,30720,75.87221218,MR,1,1123
Tama County,Iowa,IA,18103,5001,0,5001,13102,2107,10995,72.37474452,MR,19,19171
Taney County,Missouri,MO,39703,19966,0,19966,19737,565,19172,49.71160869,MU,29,29213
Tangipahoa Parish,Louisiana,LA,100588,46690,0,46690,53898,1267,52631,53.58293236,MR,22,22105
Taos County,New Mexico,NM,29979,12171,0,12171,17808,291,17517,59.40158111,MR,35,35055
Tarrant County,Texas,TX,1446219,1420743,1416321,4422,25476,815,24661,1.761558934,MU,48,48439
Tate County,Mississippi,MS,25370,7910,0,7910,17460,1078,16382,68.82144265,MR,28,28137
Tattnall County,Georgia,GA,22305,4840,0,4840,17465,725,16740,78.30082941,MR,13,13267
Taylor County,Florida,FL,19256,6527,0,6527,12729,250,12479,66.10407146,MR,12,12123
Taylor County,Georgia,GA,8815,0,0,0,8815,431,8384,100,CR,13,13269
Taylor County,Iowa,IA,6958,0,0,0,6958,971,5987,100,CR,19,19173
Taylor County,Kentucky,KY,22927,11649,0,11649,11278,1543,9735,49.19091028,MU,21,21217
Taylor County,Texas,TX,126555,109376,106840,2536,17179,679,16500,13.57433527,MU,48,48441
Taylor County,West Virginia,WV,16089,6298,0,6298,9791,218,9573,60.85524271,MR,54,54091
Taylor County,Wisconsin,WI,19680,4243,0,4243,15437,1951,13486,78.44004065,MR,55,55119
Tazewell County,Illinois,IL,128485,104571,101635,2936,23914,1713,22201,18.61228937,MU,17,17179
Tazewell County,Virginia,VA,44598,18609,0,18609,25989,564,25425,58.27391363,MR,51,51185
Tehama County,California,CA,56039,28515,0,28515,27524,1905,25619,49.11579436,MU,6,6103
Telfair County,Georgia,GA,11794,5012,0,5012,6782,218,6564,57.5038155,MR,13,13271
Teller County,Colorado,CO,20555,8543,0,8543,12012,149,11863,58.43833617,MR,8,8119
Tensas Parish,Louisiana,LA,6618,0,0,0,6618,239,6379,100,CR,22,22107
Terrebonne Parish,Louisiana,LA,104503,78397,78397,0,26106,309,25797,24.98110102,MU,22,22109
Terrell County,Georgia,GA,10970,5079,0,5079,5891,218,5673,53.70100273,MR,13,13273
Terrell County,Texas,TX,1081,0,0,0,1081,73,1008,100,CR,48,48443
Terry County,Texas,TX,12761,9211,0,9211,3550,381,3169,27.81913643,MU,48,48445
Teton County,Idaho,ID,5999,0,0,0,5999,599,5400,100,CR,16,16081
Teton County,Montana,MT,6445,0,0,0,6445,1157,5288,100,CR,30,30099
Teton County,Wyoming,WY,18251,10244,0,10244,8007,263,7744,43.87156868,MU,56,56039
Texas County,Missouri,MO,23003,194,0,194,22809,2171,20638,99.15663174,MR,29,29215
Texas County,Oklahoma,OK,20107,10515,0,10515,9592,684,8908,47.70477943,MU,40,40139
Thayer County,Nebraska,NE,6055,0,0,0,6055,871,5184,100,CR,31,31169
Thomas County,Georgia,GA,42737,20922,0,20922,21815,814,21001,51.04476215,MR,13,13275
Thomas County,Kansas,KS,8180,5359,0,5359,2821,578,2243,34.48655257,MU,20,20193
Thomas County,Nebraska,NE,729,0,0,0,729,186,543,100,CR,31,31171
Throckmorton County,Texas,TX,1850,0,0,0,1850,237,1613,100,CR,48,48447
Thurston County,Nebraska,NE,7171,0,0,0,7171,512,6659,100,CR,31,31173
Thurston County,Washington,WA,207355,156223,143898,12325,51132,1449,49683,24.65915941,MU,53,53067
Tift County,Georgia,GA,38407,21524,0,21524,16883,571,16312,43.95813263,MU,13,13277
Tillamook County,Oregon,OR,24262,5760,0,5760,18502,753,17749,76.25917072,MR,41,41057
Tillman County,Oklahoma,OK,9287,4498,0,4498,4789,527,4262,51.56670615,MR,40,40141
Tioga County,New York,NY,51784,18096,7918,10178,33688,915,32773,65.05484319,MR,36,36107
Tioga County,Pennsylvania,PA,41373,6489,0,6489,34884,1619,33265,84.31585817,MR,42,42117
Tippah County,Mississippi,MS,20826,4487,0,4487,16339,611,15728,78.4548161,MR,28,28139
Tippecanoe County,Indiana,IN,148955,125844,125844,0,23111,1156,21955,15.51542412,MU,18,18157
Tipton County,Indiana,IN,16577,5888,0,5888,10689,725,9964,64.48090728,MR,18,18159
Tipton County,Tennessee,TN,51271,17265,0,17265,34006,955,33051,66.32599325,MR,47,47167
Tishomingo County,Mississippi,MS,19163,0,0,0,19163,218,18945,100,CR,28,28141
Titus County,Texas,TX,28118,13454,0,13454,14664,893,13771,52.15164663,MR,48,48449
Todd County,Kentucky,KY,11971,0,0,0,11971,1509,10462,100,CR,21,21219
Todd County,Minnesota,MN,24426,5290,0,5290,19136,3624,15512,78.34274953,MR,27,27153
Todd County,South Dakota,SD,9050,0,0,0,9050,428,8622,100,CR,46,46121
Tolland County,Connecticut,CT,136364,84312,55784,28528,52052,365,51687,38.17136488,MU,9,9013
Tom Green County,Texas,TX,104010,88081,88081,0,15929,1252,14677,15.31487357,MU,48,48451
Tompkins County,New York,NY,96501,55898,53150,2748,40603,949,39654,42.07521166,MU,36,36109
Tooele County,Utah,UT,40735,30896,0,30896,9839,273,9566,24.1536762,MU,49,49045
Toole County,Montana,MT,5267,3026,0,3026,2241,505,1736,42.54794,MU,30,30101
Toombs County,Georgia,GA,26067,12778,0,12778,13289,521,12768,50.98016649,MR,13,13279
Torrance County,New Mexico,NM,16911,819,0,819,16092,829,15263,95.1569984,MR,35,35057
Towner County,North Dakota,ND,2876,0,0,0,2876,509,2367,100,CR,38,38095
Towns County,Georgia,GA,9319,0,0,0,9319,183,9136,100,CR,13,13281
Traill County,North Dakota,ND,8477,0,0,0,8477,657,7820,100,CR,38,38097
Transylvania County,North Carolina,NC,29334,10880,0,10880,18454,267,18187,62.90993387,MR,37,37175
Traverse County,Minnesota,MN,4134,0,0,0,4134,555,3579,100,CR,27,27155
Travis County,Texas,TX,812280,755694,734663,21031,56586,1222,55364,6.966317034,MU,48,48453
Treasure County,Montana,MT,861,0,0,0,861,178,683,100,CR,30,30103
Trego County,Kansas,KS,3319,0,0,0,3319,406,2913,100,CR,20,20195
Trempealeau County,Wisconsin,WI,27010,0,0,0,27010,2542,24468,100,CR,55,55121
Treutlen County,Georgia,GA,6854,3055,0,3055,3799,155,3644,55.4274876,MR,13,13283
Trigg County,Kentucky,KY,12597,2653,0,2653,9944,535,9409,78.93943002,MR,21,21221
Trimble County,Kentucky,KY,8125,476,0,476,7649,815,6834,94.14153846,MR,21,21223
Trinity County,California,CA,13022,0,0,0,13022,168,12854,100,CR,6,6105
Trinity County,Texas,TX,13779,0,0,0,13779,380,13399,100,CR,48,48455
Tripp County,South Dakota,SD,6430,3131,0,3131,3299,965,2334,51.30637636,MR,46,46123
Troup County,Georgia,GA,58779,33696,0,33696,25083,488,24595,42.67340377,MU,13,13285
Trousdale County,Tennessee,TN,7259,0,0,0,7259,613,6646,100,CR,47,47169
Trumbull County,Ohio,OH,225116,165474,165474,0,59642,1330,58312,26.49389648,MU,39,39155
Tucker County,West Virginia,WV,7321,0,0,0,7321,164,7157,100,CR,54,54093
Tulare County,California,CA,368021,298320,179925,118395,69701,8352,61349,18.93940835,MU,6,6107
Tulsa County,Oklahoma,OK,563299,536880,501906,34974,26419,574,25845,4.690049157,MU,40,40143
Tunica County,Mississippi,MS,9227,3785,0,3785,5442,141,5301,58.97908313,MR,28,28143
Tuolumne County,California,CA,54501,29122,0,29122,25379,355,25024,46.56611805,MU,6,6109
Turner County,Georgia,GA,9504,5010,0,5010,4494,365,4129,47.28535354,MU,13,13287
Turner County,South Dakota,SD,8849,0,0,0,8849,1781,7068,100,CR,46,46125
Tuscaloosa County,Alabama,AL,164875,116503,116503,0,48372,712,47660,29.33858984,MU,1,1125
Tuscarawas County,Ohio,OH,90914,52972,0,52972,37942,1516,36426,41.73394637,MU,39,39157
Tuscola County,Michigan,MI,58266,11650,0,11650,46616,2695,43921,80.00549205,MR,26,26157
Twiggs County,Georgia,GA,10590,0,0,0,10590,90,10500,100,CR,13,13289
Twin Falls County,Idaho,ID,64284,43321,0,43321,20963,3634,17329,32.60998071,MU,16,16083
Tyler County,Texas,TX,20871,3972,0,3972,16899,404,16495,80.96880839,MR,48,48457
Tyler County,West Virginia,WV,9592,2692,0,2692,6900,285,6615,71.93494579,MR,54,54095
Tyrrell County,North Carolina,NC,4149,0,0,0,4149,75,4074,100,CR,37,37177
Uinta County,Wyoming,WY,19742,11574,0,11574,8168,278,7890,41.373721,MU,56,56041
Uintah County,Utah,UT,25224,11515,0,11515,13709,767,12942,54.34903267,MR,49,49047
Ulster County,New York,NY,177749,90711,68653,22058,87038,761,86277,48.9668015,MU,36,36111
Umatilla County,Oregon,OR,70548,49005,0,49005,21543,2289,19254,30.53665589,MU,41,41059
Unicoi County,Tennessee,TN,17667,9580,932,8648,8087,35,8052,45.77460803,MU,47,47171
Union County,Arkansas,AR,45629,21978,0,21978,23651,527,23124,51.83326393,MR,5,5139
Union County,Florida,FL,13442,6378,0,6378,7064,164,6900,52.55170362,MR,12,12125
Union County,Georgia,GA,17289,0,0,0,17289,259,17030,100,CR,13,13291
Union County,Illinois,IL,18293,6821,0,6821,11472,633,10839,62.71251298,MR,17,17181
Union County,Indiana,IN,7349,0,0,0,7349,624,6725,100,CR,18,18161
Union County,Iowa,IA,12309,7478,0,7478,4831,990,3841,39.24770493,MU,19,19175
Union County,Kentucky,KY,15637,5513,0,5513,10124,652,9472,64.7438767,MR,21,21225
Union County,Mississippi,MS,25362,6010,0,6010,19352,793,18559,76.30313067,MR,28,28145
Union County,New Jersey,NJ,522541,522541,522541,0,0,0,0,0,MU,34,34039
Union County,New Mexico,NM,4174,0,0,0,4174,567,3607,100,CR,35,35059
Union County,North Carolina,NC,123677,62054,58370,3684,61623,2615,59008,49.8257558,MU,37,37179
Union County,Ohio,OH,40909,16193,0,16193,24716,2061,22655,60.41702315,MR,39,39159
Union County,Oregon,OR,24530,14185,0,14185,10345,1545,8800,42.17284957,MU,41,41061
Union County,Pennsylvania,PA,41624,22892,0,22892,18732,1025,17707,45.00288295,MU,42,42119
Union County,South Carolina,SC,29881,10667,0,10667,19214,459,18755,64.3017302,MR,45,45087
Union County,South Dakota,SD,12584,3347,3347,0,9237,1156,8081,73.40273363,MR,46,46127
Union County,Tennessee,TN,17808,0,0,0,17808,509,17299,100,CR,47,47173
Union Parish,Louisiana,LA,22803,3244,0,3244,19559,780,18779,85.77380169,MR,22,22111
Upshur County,Texas,TX,35291,6880,0,6880,28411,1613,26798,80.5049446,MR,48,48459
Upshur County,West Virginia,WV,23404,8997,0,8997,14407,539,13868,61.55785336,MR,54,54097
Upson County,Georgia,GA,27597,14950,0,14950,12647,314,12333,45.82744501,MU,13,13293
Upton County,Texas,TX,3404,0,0,0,3404,131,3273,100,CR,48,48461
Utah County,Utah,UT,368536,346598,303865,42733,21938,2291,19647,5.952742744,MU,49,49049
Uvalde County,Texas,TX,25926,17599,0,17599,8327,563,7764,32.1183368,MU,48,48463
Val Verde County,Texas,TX,44856,40595,0,40595,4261,130,4131,9.499286606,MU,48,48465
Valdez-Cordova Census Area,Alaska,AK,10195,0,0,0,10195,16,10179,100,CR,2,2261
Valencia County,New Mexico,NM,66152,53074,0,53074,13078,366,12712,19.76962148,MU,35,35061
Valley County,Idaho,ID,7651,0,0,0,7651,128,7523,100,CR,16,16085
Valley County,Montana,MT,7675,3372,0,3372,4303,889,3414,56.06514658,MR,30,30105
Valley County,Nebraska,NE,4647,0,0,0,4647,811,3836,100,CR,31,31175
Van Buren County,Arkansas,AR,16192,0,0,0,16192,680,15512,100,CR,5,5141
Van Buren County,Iowa,IA,7809,0,0,0,7809,1339,6470,100,CR,19,19177
Van Buren County,Michigan,MI,76263,20646,0,20646,55617,1804,53813,72.92789426,MR,26,26159
Van Buren County,Tennessee,TN,5508,0,0,0,5508,184,5324,100,CR,47,47175
Van Wert County,Ohio,OH,29659,14416,0,14416,15243,1417,13826,51.39418052,MR,39,39161
Van Zandt County,Texas,TX,48140,9920,0,9920,38220,2569,35651,79.39343581,MR,48,48467
Vance County,North Carolina,NC,42954,21122,0,21122,21832,886,20946,50.82646552,MR,37,37181
Vanderburgh County,Indiana,IN,171922,154556,154556,0,17366,575,16791,10.10109236,MU,18,18163
Venango County,Pennsylvania,PA,57565,26467,0,26467,31098,389,30709,54.02240945,MR,42,42121
Ventura County,California,CA,753197,729193,686631,42562,24004,3137,20867,3.186948434,MU,6,6111
Vermilion County,Illinois,IL,83919,59014,53056,5958,24905,1942,22963,29.67742704,MU,17,17183
Vermilion Parish,Louisiana,LA,53807,23265,506,22759,30542,1254,29288,56.76213132,MR,22,22113
Vermillion County,Indiana,IN,16788,6951,0,6951,9837,496,9341,58.5954253,MR,18,18165
Vernon County,Missouri,MO,20454,8663,0,8663,11791,1995,9796,57.64642613,MR,29,29217
Vernon County,Wisconsin,WI,28056,3960,0,3960,24096,4722,19374,85.88537211,MR,55,55123
Vernon Parish,Louisiana,LA,52531,27826,0,27826,24705,489,24216,47.02937313,MU,22,22115
Victoria County,Texas,TX,84088,61199,61199,0,22889,1358,21531,27.22029303,MU,48,48469
Vigo County,Indiana,IN,105848,79449,79449,0,26399,923,25476,24.94048069,MU,18,18167
Vilas County,Wisconsin,WI,21033,0,0,0,21033,95,20938,100,CR,55,55125
Vinton County,Ohio,OH,12806,938,0,938,11868,294,11574,92.67530845,MR,39,39163
Virginia Beach city,Virginia,VA,425257,419437,419437,0,5820,267,5553,1.368584174,MU,51,51810
Volusia County,Florida,FL,443343,402110,398489,3621,41233,946,40287,9.300473899,MU,12,12127
Wabash County,Illinois,IL,12937,7817,0,7817,5120,510,4610,39.57640875,MU,17,17185
Wabash County,Indiana,IN,34960,18144,0,18144,16816,1935,14881,48.1006865,MU,18,18169
Wabasha County,Minnesota,MN,21610,7485,0,7485,14125,2277,11848,65.36325775,MR,27,27157
Wabaunsee County,Kansas,KS,6885,0,0,0,6885,1028,5857,100,CR,20,20197
Wade Hampton Census Area,Alaska,AK,7028,0,0,0,7028,0,7028,100,CR,2,2270
Wadena County,Minnesota,MN,13713,4501,0,4501,9212,1178,8034,67.17713119,MR,27,27159
Wagoner County,Oklahoma,OK,57491,31982,24671,7311,25509,1030,24479,44.3704232,MU,40,40145
Wahkiakum County,Washington,WA,3824,0,0,0,3824,94,3730,100,CR,53,53069
Wake County,North Carolina,NC,627846,553167,540268,12899,74679,1359,73320,11.89447731,MU,37,37183
Wakulla County,Florida,FL,22863,0,0,0,22863,417,22446,100,CR,12,12129
Waldo County,Maine,ME,36280,3223,0,3223,33057,728,32329,91.11631753,MR,23,23027
Walker County,Alabama,AL,70713,16075,0,16075,54638,794,53844,77.26726345,MR,1,1127
Walker County,Georgia,GA,61053,34479,28161,6318,26574,679,25895,43.52611665,MU,13,13295
Walker County,Texas,TX,61758,39313,0,39313,22445,688,21757,36.34346967,MU,48,48471
Walla Walla County,Washington,WA,55180,44686,1305,43381,10494,1093,9401,19.01776006,MU,53,53071
Wallace County,Kansas,KS,1749,0,0,0,1749,288,1461,100,CR,20,20199
Waller County,Texas,TX,32663,11941,698,11243,20722,1152,19570,63.4418149,MR,48,48473
Wallowa County,Oregon,OR,7226,0,0,0,7226,791,6435,100,CR,41,41063
Walsh County,North Dakota,ND,12389,4461,0,4461,7928,917,7011,63.99225119,MR,38,38099
Walthall County,Mississippi,MS,15156,0,0,0,15156,815,14341,100,CR,28,28147
Walton County,Florida,FL,40601,8347,3987,4360,32254,726,31528,79.44139307,MR,12,12131
Walton County,Georgia,GA,60687,25596,8242,17354,35091,507,34584,57.82292748,MR,13,13297
Walworth County,South Dakota,SD,5974,3500,0,3500,2474,534,1940,41.41278875,MU,46,46129
Walworth County,Wisconsin,WI,93759,60114,0,60114,33645,1808,31837,35.88455508,MU,55,55127
Wapello County,Iowa,IA,36051,25146,0,25146,10905,1303,9602,30.24881418,MU,19,19179
Ward County,North Dakota,ND,58795,45278,0,45278,13517,1831,11686,22.99005017,MU,38,38101
Ward County,Texas,TX,10909,7351,0,7351,3558,154,3404,32.61527179,MU,48,48475
Ware County,Georgia,GA,35483,25410,0,25410,10073,513,9560,28.38824226,MU,13,13299
Warren County,Georgia,GA,6336,0,0,0,6336,300,6036,100,CR,13,13301
Warren County,Illinois,IL,18735,10123,0,10123,8612,1251,7361,45.96744062,MU,17,17187
Warren County,Indiana,IN,8419,0,0,0,8419,858,7561,100,CR,18,18171
Warren County,Iowa,IA,40671,23813,7448,16365,16858,2059,14799,41.44968159,MU,19,19181
Warren County,Kentucky,KY,92522,58249,58249,0,34273,2135,32138,37.04308165,MU,21,21227
Warren County,Mississippi,MS,49644,31371,0,31371,18273,252,18021,36.80807348,MU,28,28149
Warren County,Missouri,MO,24525,5238,0,5238,19287,843,18444,78.64220183,MR,29,29219
Warren County,New Jersey,NJ,102437,58512,43018,15494,43925,1194,42731,42.88001406,MU,34,34041
Warren County,New York,NY,63303,38311,35466,2845,24992,114,24878,39.47996146,MU,36,36113
Warren County,North Carolina,NC,19972,0,0,0,19972,605,19367,100,CR,37,37185
Warren County,Ohio,OH,158383,122747,101293,21454,35636,1651,33985,22.49988951,MU,39,39165
Warren County,Pennsylvania,PA,43863,19899,0,19899,23964,442,23522,54.63374598,MR,42,42123
Warren County,Tennessee,TN,38276,14436,0,14436,23840,1549,22291,62.28446024,MR,47,47177
Warren County,Virginia,VA,31584,13882,0,13882,17702,456,17246,56.04736575,MR,51,51187
Warrick County,Indiana,IN,52383,37396,30546,6850,14987,615,14372,28.61042705,MU,18,18173
Wasatch County,Utah,UT,15215,9705,0,9705,5510,295,5215,36.21426224,MU,49,49051
Wasco County,Oregon,OR,23791,15740,0,15740,8051,687,7364,33.84052793,MU,41,41065
Waseca County,Minnesota,MN,19526,9792,0,9792,9734,1371,8363,49.85148008,MU,27,27161
Washakie County,Wyoming,WY,8289,5631,0,5631,2658,336,2322,32.06659428,MU,56,56043
Washburn County,Wisconsin,WI,16036,2662,0,2662,13374,669,12705,83.39985034,MR,55,55129
Washington County,Alabama,AL,18097,0,0,0,18097,622,17475,100,CR,1,1129
Washington County,Arkansas,AR,157715,109737,107220,2517,47978,3024,44954,30.42069556,MU,5,5143
Washington County,Colorado,CO,4926,0,0,0,4926,1137,3789,100,CR,8,8121
Washington County,Florida,FL,20973,3624,0,3624,17349,468,16881,82.72064082,MR,12,12133
Washington County,Georgia,GA,21176,7158,0,7158,14018,654,13364,66.19758217,MR,13,13303
Washington County,Idaho,ID,9977,5472,0,5472,4505,732,3773,45.15385386,MU,16,16087
Washington County,Illinois,IL,15148,3137,0,3137,12011,1431,10580,79.29099551,MR,17,17189
Washington County,Indiana,IN,27223,6261,0,6261,20962,1619,19343,77.00106528,MR,18,18175
Washington County,Iowa,IA,20670,6790,0,6790,13880,2095,11785,67.1504596,MR,19,19183
Washington County,Kansas,KS,6483,0,0,0,6483,1241,5242,100,CR,20,20201
Washington County,Kentucky,KY,10916,0,0,0,10916,1795,9121,100,CR,21,21229
Washington County,Maine,ME,33941,2726,0,2726,31215,396,30819,91.96841578,MR,23,23029
Washington County,Maryland,MD,131923,89424,84651,4773,42499,1953,40546,32.21500421,MU,24,24043
Washington County,Minnesota,MN,201130,165013,127661,37352,36117,1366,34751,17.95704271,MU,27,27163
Washington County,Mississippi,MS,62977,52226,0,52226,10751,426,10325,17.07131175,MU,28,28151
Washington County,Missouri,MO,23344,4726,0,4726,18618,609,18009,79.75496916,MR,29,29221
Washington County,Nebraska,NE,18780,7357,0,7357,11423,1732,9691,60.82534611,MR,31,31177
Washington County,New York,NY,61042,18042,12875,5167,43000,1558,41442,70.44330133,MR,36,36115
Washington County,North Carolina,NC,13723,4729,0,4729,8994,313,8681,65.53960504,MR,37,37187
Washington County,Ohio,OH,63251,22245,21363,882,41006,1299,39707,64.83059556,MR,39,39167
Washington County,Oklahoma,OK,48996,38345,0,38345,10651,872,9779,21.73850927,MU,40,40147
Washington County,Oregon,OR,445342,414691,414691,0,30651,3635,27016,6.882575638,MU,41,41067
Washington County,Pennsylvania,PA,202897,128032,121985,6047,74865,1615,73250,36.89803201,MU,42,42125
Washington County,Rhode Island,RI,123546,86702,61587,25115,36844,430,36414,29.82209056,MU,44,44009
Washington County,Tennessee,TN,107198,72263,72263,0,34935,1873,33062,32.58922741,MU,47,47179
Washington County,Texas,TX,30373,13912,0,13912,16461,2208,14253,54.19616106,MR,48,48477
Washington County,Utah,UT,90354,72550,62654,9896,17804,293,17511,19.704717,MU,49,49053
Washington County,Vermont,VT,58039,28279,0,28279,29760,688,29072,51.27586623,MR,50,50023
Washington County,Virginia,VA,51103,15502,3071,12431,35601,2163,33438,69.665186,MR,51,51191
Washington County,Wisconsin,WI,117493,76752,15384,61368,40741,1722,39019,34.67525725,MU,55,55131
Washington Parish,Louisiana,LA,43926,16662,0,16662,27264,994,26270,62.06802349,MR,22,22117
Washita County,Oklahoma,OK,11508,3030,0,3030,8478,1061,7417,73.67049009,MR,40,40149
Washoe County,Nevada,NV,339486,315335,304013,11322,24151,232,23919,7.113989973,MU,32,32031
Washtenaw County,Michigan,MI,322895,266463,256972,9491,56432,1993,54439,17.47688877,MU,26,26161
Watauga County,North Carolina,NC,42695,17089,0,17089,25606,691,24915,59.97423586,MR,37,37189
Watonwan County,Minnesota,MN,11876,4658,0,4658,7218,1285,5933,60.77803974,MR,27,27165
Waukesha County,Wisconsin,WI,360767,317579,305242,12337,43188,813,42375,11.97116144,MU,55,55133
Waupaca County,Wisconsin,WI,51731,19187,0,19187,32544,2151,30393,62.91005393,MR,55,55135
Waushara County,Wisconsin,WI,23154,65,0,65,23089,1067,22022,99.71927097,MR,55,55137
Wayne County,Georgia,GA,26565,12810,0,12810,13755,186,13569,51.77865613,MR,13,13305
Wayne County,Illinois,IL,17151,5173,0,5173,11978,1584,10394,69.83849338,MR,17,17191
Wayne County,Indiana,IN,71097,48989,0,48989,22108,1738,20370,31.09554552,MU,18,18177
Wayne County,Iowa,IA,6730,0,0,0,6730,993,5737,100,CR,19,19185
Wayne County,Kentucky,KY,19923,6198,0,6198,13725,1003,12722,68.89022738,MR,21,21231
Wayne County,Michigan,MI,2061162,2046954,2046838,116,14208,218,13990,0.689319908,MU,26,26163
Wayne County,Mississippi,MS,21216,4884,0,4884,16332,887,15445,76.97963801,MR,28,28153
Wayne County,Missouri,MO,13259,0,0,0,13259,213,13046,100,CR,29,29223
Wayne County,Nebraska,NE,9851,5527,0,5527,4324,1291,3033,43.89402091,MU,31,31179
Wayne County,New York,NY,93765,34319,8968,25351,59446,1781,57665,63.39892284,MR,36,36117
Wayne County,North Carolina,NC,113329,62510,57559,4951,50819,1181,49638,44.84200867,MU,37,37191
Wayne County,Ohio,OH,111564,53662,5870,47792,57902,4824,53078,51.90025456,MR,39,39169
Wayne County,Pennsylvania,PA,47722,7698,1564,6134,40024,822,39202,83.86907506,MR,42,42127
Wayne County,Tennessee,TN,16842,0,0,0,16842,707,16135,100,CR,47,47181
Wayne County,Utah,UT,2509,0,0,0,2509,159,2350,100,CR,49,49055
Wayne County,West Virginia,WV,42903,16437,15640,797,26466,286,26180,61.68799385,MR,54,54099
Waynesboro city,Virginia,VA,19520,19072,0,19072,448,0,448,2.295081967,MU,51,51820
Weakley County,Tennessee,TN,34895,10031,0,10031,24864,1193,23671,71.25376128,MR,47,47183
Webb County,Texas,TX,193117,184925,175841,9084,8192,321,7871,4.241988018,MU,48,48479
Weber County,Utah,UT,196533,183300,183300,0,13233,629,12604,6.733220375,MU,49,49057
Webster County,Georgia,GA,2390,0,0,0,2390,147,2243,100,CR,13,13307
Webster County,Iowa,IA,40235,25692,0,25692,14543,1865,12678,36.14514726,MU,19,19187
Webster County,Kentucky,KY,14120,3001,0,3001,11119,726,10393,78.74645892,MR,21,21233
Webster County,Mississippi,MS,10294,0,0,0,10294,254,10040,100,CR,28,28155
Webster County,Missouri,MO,31045,6114,0,6114,24931,2623,22308,80.30600741,MR,29,29225
Webster County,Nebraska,NE,4061,0,0,0,4061,718,3343,100,CR,31,31181
Webster County,West Virginia,WV,9719,0,0,0,9719,206,9513,100,CR,54,54101
Webster Parish,Louisiana,LA,41831,19500,0,19500,22331,517,21814,53.38385408,MR,22,22119
Weld County,Colorado,CO,180936,130060,96415,33645,50876,6622,44254,28.11822965,MU,8,8123
Wells County,Indiana,IN,27600,13400,0,13400,14200,2221,11979,51.44927536,MR,18,18179
Wells County,North Dakota,ND,5102,0,0,0,5102,963,4139,100,CR,38,38103
West Baton Rouge Parish,Louisiana,LA,21601,12961,6600,6361,8640,29,8611,39.99814823,MU,22,22121
West Carroll Parish,Louisiana,LA,12314,0,0,0,12314,623,11691,100,CR,22,22123
West Feliciana Parish,Louisiana,LA,15111,0,0,0,15111,170,14941,100,CR,22,22125
Westchester County,New York,NY,923459,891569,891569,0,31890,245,31645,3.453320613,MU,36,36119
Westmoreland County,Pennsylvania,PA,369993,274825,257781,17044,95168,1412,93756,25.72156771,MU,42,42129
Westmoreland County,Virginia,VA,16718,4300,0,4300,12418,371,12047,74.27922,MR,51,51193
Weston County,Wyoming,WY,6644,3007,0,3007,3637,203,3434,54.74111981,MR,56,56045
Wetzel County,West Virginia,WV,17693,8211,0,8211,9482,269,9213,53.59181597,MR,54,54103
Wexford County,Michigan,MI,30484,11160,0,11160,19324,384,18940,63.39063115,MR,26,26165
Wharton County,Texas,TX,41188,20713,0,20713,20475,1454,19021,49.7110809,MU,48,48481
Whatcom County,Washington,WA,166814,113006,84499,28507,53808,2372,51436,32.25628544,MU,53,53073
Wheatland County,Montana,MT,2259,0,0,0,2259,278,1981,100,CR,30,30107
Wheeler County,Georgia,GA,6179,0,0,0,6179,229,5950,100,CR,13,13309
Wheeler County,Nebraska,NE,886,0,0,0,886,362,524,100,CR,31,31183
Wheeler County,Oregon,OR,1547,0,0,0,1547,236,1311,100,CR,41,41069
Wheeler County,Texas,TX,5284,0,0,0,5284,417,4867,100,CR,48,48483
White County,Arkansas,AR,67165,29880,0,29880,37285,1525,35760,55.51254374,MR,5,5145
White County,Georgia,GA,19944,0,0,0,19944,431,19513,100,CR,13,13311
White County,Illinois,IL,15371,5579,0,5579,9792,865,8927,63.70437837,MR,17,17193
White County,Indiana,IN,25267,8805,0,8805,16462,1085,15377,65.15217477,MR,18,18181
White County,Tennessee,TN,23102,4080,0,4080,19022,1238,17784,82.33919141,MR,47,47185
White Pine County,Nevada,NV,9181,4299,0,4299,4882,137,4745,53.1750354,MR,32,32033
Whiteside County,Illinois,IL,60653,39268,0,39268,21385,1911,19474,35.25794272,MU,17,17195
Whitfield County,Georgia,GA,83525,57143,57143,0,26382,593,25789,31.58575277,MU,13,13313
Whitley County,Indiana,IN,30707,7439,0,7439,23268,1665,21603,75.77425343,MR,18,18183
Whitley County,Kentucky,KY,35865,13467,0,13467,22398,210,22188,62.45085738,MR,21,21235
Whitman County,Washington,WA,40740,27458,0,27458,13282,1755,11527,32.60186549,MU,53,53075
Wibaux County,Montana,MT,1068,0,0,0,1068,278,790,100,CR,30,30109
Wichita County,Kansas,KS,2531,0,0,0,2531,254,2277,100,CR,20,20203
Wichita County,Texas,TX,131664,121802,98090,23712,9862,721,9141,7.490278284,MU,48,48485
Wicomico County,Maryland,MD,84644,57867,57867,0,26777,1075,25702,31.63484712,MU,24,24045
Wilbarger County,Texas,TX,14676,11268,0,11268,3408,473,2935,23.22158626,MU,48,48487
Wilcox County,Alabama,AL,13183,0,0,0,13183,355,12828,100,CR,1,1131
Wilcox County,Georgia,GA,8577,0,0,0,8577,329,8248,100,CR,13,13315
Wilkes County,Georgia,GA,10687,3544,0,3544,7143,297,6846,66.83821465,MR,13,13317
Wilkes County,North Carolina,NC,65632,17248,0,17248,48384,1363,47021,73.72013652,MR,37,37193
Wilkin County,Minnesota,MN,7138,3537,0,3537,3601,695,2906,50.44830485,MR,27,27167
Wilkinson County,Georgia,GA,10220,0,0,0,10220,324,9896,100,CR,13,13319
Wilkinson County,Mississippi,MS,10312,0,0,0,10312,495,9817,100,CR,28,28157
Will County,Illinois,IL,502266,469326,450815,18511,32940,2045,30895,6.558277885,MU,17,17197
Willacy County,Texas,TX,20082,10237,0,10237,9845,240,9605,49.02400159,MU,48,48489
Williams County,North Dakota,ND,19761,13048,0,13048,6713,841,5872,33.97095289,MU,38,38105
Williams County,Ohio,OH,39188,13057,0,13057,26131,1428,24703,66.68112688,MR,39,39171
Williamsburg city,Virginia,VA,11998,11998,11998,0,0,0,0,0,MU,51,51830
Williamsburg County,South Carolina,SC,37217,5638,0,5638,31579,727,30852,84.85100895,MR,45,45089
Williamson County,Illinois,IL,61296,39200,0,39200,22096,586,21510,36.04802924,MU,17,17199
Williamson County,Tennessee,TN,126638,89512,80583,8929,37126,1700,35426,29.31663482,MU,47,47187
Williamson County,Texas,TX,249967,208768,161657,47111,41199,2959,38240,16.48177559,MU,48,48491
Wilson County,Kansas,KS,10332,2910,0,2910,7422,896,6526,71.83507549,MR,20,20205
Wilson County,North Carolina,NC,73814,46577,0,46577,27237,948,26289,36.89950416,MU,37,37195
Wilson County,Tennessee,TN,88809,47868,27132,20736,40941,1936,39005,46.10005743,MU,47,47189
Wilson County,Texas,TX,32408,5641,0,5641,26767,1805,24962,82.593804,MR,48,48493
Winchester city,Virginia,VA,23585,23585,23585,0,0,0,0,0,MU,51,51840
Windham County,Connecticut,CT,109091,55634,11283,44351,53457,600,52857,49.00220916,MU,9,9015
Windham County,Vermont,VT,44216,12536,0,12536,31680,534,31146,71.64827212,MR,50,50025
Windsor County,Vermont,VT,57418,14386,0,14386,43032,746,42286,74.94513915,MR,50,50027
Winkler County,Texas,TX,7173,5803,0,5803,1370,30,1340,19.09940053,MU,48,48495
Winn Parish,Louisiana,LA,16894,5972,0,5972,10922,96,10826,64.65017166,MR,22,22127
Winnebago County,Illinois,IL,278418,255521,255521,0,22897,1665,21232,8.223965405,MU,17,17201
Winnebago County,Iowa,IA,11723,3919,0,3919,7804,987,6817,66.56999062,MR,19,19189
Winnebago County,Wisconsin,WI,156763,132047,129125,2922,24716,1474,23242,15.76647551,MU,55,55139
Winneshiek County,Iowa,IA,21310,7609,0,7609,13701,3216,10485,64.2937588,MR,19,19191
Winona County,Minnesota,MN,49985,32311,0,32311,17674,2679,14995,35.35860758,MU,27,27169
Winston County,Alabama,AL,24843,4070,0,4070,20773,748,20025,83.61711549,MR,1,1133
Winston County,Mississippi,MS,20160,5008,0,5008,15152,487,14665,75.15873016,MR,28,28159
Wirt County,West Virginia,WV,5873,0,0,0,5873,207,5666,100,CR,54,54105
Wise County,Texas,TX,48793,9147,346,8801,39646,2615,37031,81.25345849,MR,48,48497
Wise County,Virginia,VA,40123,15269,0,15269,24854,115,24739,61.9445206,MR,51,51195
Wolfe County,Kentucky,KY,7065,0,0,0,7065,662,6403,100,CR,21,21237
Wood County,Ohio,OH,121065,81641,46772,34869,39424,2440,36984,32.56432495,MU,39,39173
Wood County,Texas,TX,36752,7541,0,7541,29211,1349,27862,79.48138877,MR,48,48499
Wood County,West Virginia,WV,87986,64429,64429,0,23557,575,22982,26.77357761,MU,54,54107
Wood County,Wisconsin,WI,75555,47644,0,47644,27911,2102,25809,36.94130104,MU,55,55141
Woodbury County,Iowa,IA,103877,86701,86701,0,17176,2130,15046,16.53494036,MU,19,19193
Woodford County,Illinois,IL,35469,14602,0,14602,20867,1614,19253,58.83165581,MR,17,17203
Woodford County,Kentucky,KY,23208,13641,0,13641,9567,1250,8317,41.22285419,MU,21,21239
Woodruff County,Arkansas,AR,8741,0,0,0,8741,275,8466,100,CR,5,5147
Woods County,Oklahoma,OK,9089,5851,0,5851,3238,579,2659,35.62548135,MU,40,40151
Woodson County,Kansas,KS,3788,0,0,0,3788,539,3249,100,CR,20,20207
Woodward County,Oklahoma,OK,18486,10896,0,10896,7590,642,6948,41.05809802,MU,40,40153
Worcester County,Maryland,MD,46543,29593,0,29593,16950,667,16283,36.4179361,MU,24,24047
Worcester County,Massachusetts,MA,750963,606832,583709,23123,144131,1586,142545,19.19282308,MU,25,25027
Worth County,Georgia,GA,21967,6596,0,6596,15371,781,14590,69.97314153,MR,13,13321
Worth County,Iowa,IA,7909,0,0,0,7909,1212,6697,100,CR,19,19195
Worth County,Missouri,MO,2382,0,0,0,2382,493,1889,100,CR,29,29227
Wrangell-Petersburg Census Area,Alaska,AK,6684,2792,0,2792,3892,7,3885,58.22860563,MR,2,2280
Wright County,Iowa,IA,14334,6039,0,6039,8295,1168,7127,57.86940142,MR,19,19197
Wright County,Minnesota,MN,89986,41968,0,41968,48018,3286,44732,53.36163403,MR,27,27171
Wright County,Missouri,MO,17955,4345,0,4345,13610,2126,11484,75.80061264,MR,29,29229
Wyandot County,Ohio,OH,22908,9991,0,9991,12917,1495,11422,56.38641523,MR,39,39175
Wyandotte County,Kansas,KS,157882,149491,149491,0,8391,172,8219,5.314728721,MU,20,20209
Wyoming County,New York,NY,43424,15518,0,15518,27906,1656,26250,64.26400147,MR,36,36121
Wyoming County,Pennsylvania,PA,28080,4221,1188,3033,23859,524,23335,84.96794872,MR,42,42131
Wyoming County,West Virginia,WV,25708,2973,0,2973,22735,188,22547,88.43550646,MR,54,54109
Wythe County,Virginia,VA,27599,6665,0,6665,20934,777,20157,75.8505743,MR,51,51197
Yadkin County,North Carolina,NC,36348,5041,0,5041,31307,1367,29940,86.13128645,MR,37,37197
Yakima County,Washington,WA,222581,158403,112696,45707,64178,5253,58925,28.83354824,MU,53,53077
Yakutat City and Borough,Alaska,AK,808,0,0,0,808,0,808,100,CR,2,2282
Yalobusha County,Mississippi,MS,13051,2529,0,2529,10522,458,10064,80.62217455,MR,28,28161
Yamhill County,Oregon,OR,84992,59929,0,59929,25063,3982,21081,29.48865776,MU,41,41071
Yancey County,North Carolina,NC,17774,0,0,0,17774,653,17121,100,CR,37,37199
Yankton County,South Dakota,SD,21652,13127,0,13127,8525,1448,7077,39.37280621,MU,46,46135
Yates County,New York,NY,24621,6584,0,6584,18037,2028,16009,73.25860038,MR,36,36123
Yavapai County,Arizona,AZ,167517,104862,61891,42971,62655,537,62118,37.40217411,MU,4,4025
Yazoo County,Mississippi,MS,28149,14858,0,14858,13291,434,12857,47.21659739,MU,28,28163
Yell County,Arkansas,AR,21139,3962,0,3962,17177,1236,15941,81.25739155,MR,5,5149
Yellow Medicine County,Minnesota,MN,11080,2005,0,2005,9075,2028,7047,81.90433213,MR,27,27173
Yellowstone County,Montana,MT,129352,107756,100051,7705,21596,2067,19529,16.69552848,MU,30,30111
Yoakum County,Texas,TX,7322,4387,0,4387,2935,174,2761,40.08467632,MU,48,48501
Yolo County,California,CA,168660,152956,97319,55637,15704,1459,14245,9.311039962,MU,6,6113
York County,Maine,ME,186742,86910,54740,32170,99832,1269,98563,53.4598537,MR,23,23031
York County,Nebraska,NE,14598,7890,0,7890,6708,1397,5311,45.95150021,MU,31,31185
York County,Pennsylvania,PA,381751,273017,222525,50492,108734,3372,105362,28.48296403,MU,42,42133
York County,South Carolina,SC,164614,105846,94589,11257,58768,995,57773,35.7004872,MU,45,45091
York County,Virginia,VA,56297,50952,50952,0,5345,12,5333,9.494289216,MU,51,51199
Young County,Texas,TX,17943,12224,0,12224,5719,466,5253,31.87315388,MU,48,48503
Yuba County,California,CA,60219,42099,36949,5150,18120,550,17570,30.09017088,MU,6,6115
Yukon-Koyukuk Census Area,Alaska,AK,6551,0,0,0,6551,10,6541,100,CR,2,2290
Yuma County,Arizona,AZ,160026,139054,93508,45546,20972,629,20343,13.10537038,MU,4,4027
Yuma County,Colorado,CO,9841,3251,0,3251,6590,1407,5183,66.96473936,MR,8,8125
Zapata County,Texas,TX,12182,8573,0,8573,3609,0,3609,29.62567723,MU,48,48505
Zavala County,Texas,TX,11600,7277,0,7277,4323,154,4169,37.26724138,MU,48,48507
Ziebach County,South Dakota,SD,2519,0,0,0,2519,354,2165,100,CR,46,46137
